冲入骑手脱轨的港湾	冲|入|骑|手|脱|轨|的|港|湾	0
黑水晶面对铁锤必须绽开微笑	黑|水|晶|面|对|铁|锤|必|须|绽|开|微|笑	2
[Title]你的肉体，如今已是尘土和行星	[|T|i|t|l|e|]|你|的|肉|体|，|如|今|已|是|尘|土|和|行|星	1
芜青堆中跪着的梦想；	芜|青|堆|中|跪|着|的|梦|想|；	2
屋顶偏西	屋|顶|偏|西	0
我终于能够理解  他对这世界的憎与爱	我|终|于|能|够|理|解| | |他|对|这|世|界|的|憎|与|爱	0
一生就是这样在守望中舔起伤口。	一|生|就|是|这|样|在|守|望|中|舔|起|伤|口|。	0
紧密地，像是一个人，不能肯定它是坚强或懦弱，	紧|密|地|，|像|是|一|个|人|，|不|能|肯|定|它|是|坚|强|或|懦|弱|，	1
我坐在树底下，看见所有词语在一松手之后	我|坐|在|树|底|下|，|看|见|所|有|词|语|在|一|松|手|之|后	0
而我，你的爱人，好似死神。	而|我|，|你|的|爱|人|，|好|似|死|神|。	1
我说不出来	我|说|不|出|来	0
这绝对的沉寂被嵌在一颗不名的星球	这|绝|对|的|沉|寂|被|嵌|在|一|颗|不|名|的|星|球	1
夕阳底下白色大厦回光返照，退去更其遥远。	夕|阳|底|下|白|色|大|厦|回|光|返|照|，|退|去|更|其|遥|远|。	0
仿佛唯有风暴中才有安详！	仿|佛|唯|有|风|暴|中|才|有|安|详|！	1
木头在开花，时候	木|头|在|开|花|，|时|候	0
仿佛饥饿的肚子春暖花开	仿|佛|饥|饿|的|肚|子|春|暖|花|开	1
仿佛在游耍、戏弄。	仿|佛|在|游|耍|、|戏|弄|。	1
她沉重的臀部，让以后的天空	她|沉|重|的|臀|部|，|让|以|后|的|天|空	0
声声哭喊仿佛是首悠长的歌，	声|声|哭|喊|仿|佛|是|首|悠|长|的|歌|，	1
温柔地抚摸大地，穿过美丽丰饶的园林	温|柔|地|抚|摸|大|地|，|穿|过|美|丽|丰|饶|的|园|林	2
它们与你无关	它|们|与|你|无|关	0
一切会消逝，如白苹果树的烟花，	一|切|会|消|逝|，|如|白|苹|果|树|的|烟|花|，	1
我没有说话	我|没|有|说|话	0
等翻开瓦顶，下面的尘埃就升起来	等|翻|开|瓦|顶|，|下|面|的|尘|埃|就|升|起|来	2
都让泊在异乡的孤独日子，	都|让|泊|在|异|乡|的|孤|独|日|子|，	0
水是忧愁的。她从冰冷的	水|是|忧|愁|的|。|她|从|冰|冷|的	2
叫喊着，而风拖着我螺夫的嗓门。	叫|喊|着|，|而|风|拖|着|我|螺|夫|的|嗓|门|。	2
她们冷漠之时像冰雪，燃烧起来火一样。	她|们|冷|漠|之|时|像|冰|雪|，|燃|烧|起|来|火|一|样|。	2
都贴着那样的海报。现在	都|贴|着|那|样|的|海|报|。|现|在	0
摇动起来，就开始了毕直的路	摇|动|起|来|，|就|开|始|了|毕|直|的|路	2
满足伊的羞耻心和淫荡	满|足|伊|的|羞|耻|心|和|淫|荡	0
几乎像是茫然失措，观望着与他一起在示拿的人们，	几|乎|像|是|茫|然|失|措|，|观|望|着|与|他|一|起|在|示|拿|的|人|们|，	1
这仿佛是一个魔瓶乖巧的入口	这|仿|佛|是|一|个|魔|瓶|乖|巧|的|入|口	1
仅仅仅六亿个我无比真实	仅|仅|仅|六|亿|个|我|无|比|真|实	0
什么	什|么	0
呵，那飞驰的长途客车，那擦着耳朵的风，让他滚动得多么快。	呵|，|那|飞|驰|的|长|途|客|车|，|那|擦|着|耳|朵|的|风|，|让|他|滚|动|得|多|么|快|。	0
宛如一根柱子。	宛|如|一|根|柱|子|。	1
宣布处女的希望已发现正在走来	宣|布|处|女|的|希|望|已|发|现|正|在|走|来	2
仿佛在形成大理石的黄色秋天里	仿|佛|在|形|成|大|理|石|的|黄|色|秋|天|里	1
铁圈如古老的坟墓禁锢着我的头	铁|圈|如|古|老|的|坟|墓|禁|锢|着|我|的|头	1
如同人们在胜利的场地树起	如|同|人|们|在|胜|利|的|场|地|树|起	1
一生就是这样在泪水中默默吞忍。	一|生|就|是|这|样|在|泪|水|中|默|默|吞|忍|。	0
望去使你的全身都觉得凄冷。	望|去|使|你|的|全|身|都|觉|得|凄|冷|。	0
这世界最后一片庄稼	这|世|界|最|后|一|片|庄|稼	0
几个弄纸牌的闲人  以及他们的大哥	几|个|弄|纸|牌|的|闲|人| | |以|及|他|们|的|大|哥	0
每一次都仿佛踏入虚空	每|一|次|都|仿|佛|踏|入|虚|空	1
在没有早晨的明天里	在|没|有|早|晨|的|明|天|里	0
月光梦一般漫溢在安睡的大地。	月|光|梦|一|般|漫|溢|在|安|睡|的|大|地|。	2
金龟子犹如生命的黄金，	金|龟|子|犹|如|生|命|的|黄|金|，	1
仿佛在两块木头中打进一个榫子，在一段乐章中插入一个慢调。	仿|佛|在|两|块|木|头|中|打|进|一|个|榫|子|，|在|一|段|乐|章|中|插|入|一|个|慢|调|。	0
那地下没有墓。	那|地|下|没|有|墓|。	1
一样也会勒着我们	一|样|也|会|勒|着|我|们	0
犹如婴儿诞生在穷苦人家，	犹|如|婴|儿|诞|生|在|穷|苦|人|家|，	1
它们的存在是历史	它|们|的|存|在|是|历|史	0
还亮在人群中央凹下去的圆台上	还|亮|在|人|群|中|央|凹|下|去|的|圆|台|上	0
彻夜娓娓的倾诉变成了	彻|夜|娓|娓|的|倾|诉|变|成|了	2
象一阵骤雨催开了多少野花芬芳	象|一|阵|骤|雨|催|开|了|多|少|野|花|芬|芳	1
睡眠湿润的嘴唇	睡|眠|湿|润|的|嘴|唇	2
亚麻色的农妇	亚|麻|色|的|农|妇	0
如水般干涸在我的眼前	如|水|般|干|涸|在|我|的|眼|前	0
为什么火一燃烧就诞生，为什么生命一热情就化为乌有	为|什|么|火|一|燃|烧|就|诞|生|，|为|什|么|生|命|一|热|情|就|化|为|乌|有	2
就象露珠亲吻着花唇，	就|象|露|珠|亲|吻|着|花|唇|，	1
犹如被弃之不割的谷穗娇喘	犹|如|被|弃|之|不|割|的|谷|穗|娇|喘	1
敞开心扉，就象牡丹张开了花蕊	敞|开|心|扉|，|就|象|牡|丹|张|开|了|花|蕊	1
我可以足够精确地形容她们	我|可|以|足|够|精|确|地|形|容|她|们	0
然而，为自己的模糊而痛苦不已的言语，缠绕着我的思绪，犹如彷徨在群山之上的	然|而|，|为|自|己|的|模|糊|而|痛|苦|不|已|的|言|语|，|缠|绕|着|我|的|思|绪|，|犹|如|彷|徨|在|群|山|之|上|的	1
护佑着我，于黄昏的思绪之中。	护|佑|着|我|，|于|黄|昏|的|思|绪|之|中|。	2
故事是关于女儿，如何在	故|事|是|关|于|女|儿|，|如|何|在	0
他随朝霞一道从地平线上出来	他|随|朝|霞|一|道|从|地|平|线|上|出|来	0
你象浪花一样白皙而又美妙，	你|象|浪|花|一|样|白|皙|而|又|美|妙|，	1
非常尖。他弄懂了“我是另一个”。	非|常|尖|。|他|弄|懂|了|“|我|是|另|一|个|”|。	0
象绳结打开又系上	象|绳|结|打|开|又|系|上	1
他已经连续给我打了一年的电话了	他|已|经|连|续|给|我|打|了|一|年|的|电|话|了	0
又好似石筑的避难的良港	又|好|似|石|筑|的|避|难|的|良|港	1
可以是我的未来可以是这个夜晚	可|以|是|我|的|未|来|可|以|是|这|个|夜|晚	0
炝葱花的气味。我带着它上路	炝|葱|花|的|气|味|。|我|带|着|它|上|路	1
仿佛在出席葬礼373	仿|佛|在|出|席|葬|礼|3|7|3	1
象忘俗的僧人	象|忘|俗|的|僧|人	1
光阴浩大	光|阴|浩|大	0
管他荒唐不荒唐。甚至辉煌。	管|他|荒|唐|不|荒|唐|。|甚|至|辉|煌|。	0
什么都不知道	什|么|都|不|知|道	0
花儿开了，像一只只五颜六色的蝴蝶。	花|儿|开|了|，|像|一|只|只|五|颜|六|色|的|蝴|蝶|。	1
明天我是狂风，嗷嗷吼叫的风，	明|天|我|是|狂|风|，|嗷|嗷|吼|叫|的|风|，	1
他的眼睑臃肿，像一个主教	他|的|眼|睑|臃|肿|，|像|一|个|主|教	1
秋雨像一位害羞的小姑娘，总是迈着缓慢的脚步，姗姗来迟。	秋|雨|像|一|位|害|羞|的|小|姑|娘|，|总|是|迈|着|缓|慢|的|脚|步|，|姗|姗|来|迟|。	2
流泉在这里哭诉着虚无的永恒。	流|泉|在|这|里|哭|诉|着|虚|无|的|永|恒|。	2
冷冷的光亮  仿佛狼的眼睛	冷|冷|的|光|亮| | |仿|佛|狼|的|眼|睛	1
好似拍打悬崖的浪花，	好|似|拍|打|悬|崖|的|浪|花|，	1
一小块阴影中低着头，仿佛有所思。	一|小|块|阴|影|中|低|着|头|，|仿|佛|有|所|思|。	1
仿佛一片绿叶飘过	仿|佛|一|片|绿|叶|飘|过	1
犹如一叶轻舟，在水上飘游。	犹|如|一|叶|轻|舟|，|在|水|上|飘|游|。	1
他象个怕见人的理发师，	他|象|个|怕|见|人|的|理|发|师|，	1
从渴望的迷宫里伸出	从|渴|望|的|迷|宫|里|伸|出	2
仿佛姑娘的嘴唇，嚼着熟莓子。	仿|佛|姑|娘|的|嘴|唇|，|嚼|着|熟|莓|子|。	1
它在窗帘后面	它|在|窗|帘|后|面	0
当他们朝前看，象习惯于依靠星星辨别方向的旅行者，	当|他|们|朝|前|看|，|象|习|惯|于|依|靠|星|星|辨|别|方|向|的|旅|行|者|，	1
如果爱情好似生命，我的亲人，	如|果|爱|情|好|似|生|命|，|我|的|亲|人|，	1
升起，弥满，它没有方向的圆妙，	升|起|，|弥|满|，|它|没|有|方|向|的|圆|妙|，	0
走进它们的火圈，走进小树林古老的悲伤，	走|进|它|们|的|火|圈|，|走|进|小|树|林|古|老|的|悲|伤|，	2
千百万个刻骨的意义射过来像利箭，	千|百|万|个|刻|骨|的|意|义|射|过|来|像|利|箭|，	1
眺望，不可能平静	眺|望|，|不|可|能|平|静	2
安静的性格，活泼而柔和的	安|静|的|性|格|，|活|泼|而|柔|和|的	2
把挫折当成病，把悲哀的债务还清；	把|挫|折|当|成|病|，|把|悲|哀|的|债|务|还|清|；	1
让一切故事的开始	让|一|切|故|事|的|开|始	0
哦，身体里拥挤不堪，好像有人上车，	哦|，|身|体|里|拥|挤|不|堪|，|好|像|有|人|上|车|，	1
像印度女人一定要露出她们腰里的肉	像|印|度|女|人|一|定|要|露|出|她|们|腰|里|的|肉	1
双腿像婴儿一样盲目	双|腿|像|婴|儿|一|样|盲|目	1
肉体的极度兴奋，痛快的跳舞	肉|体|的|极|度|兴|奋|，|痛|快|的|跳|舞	2
回忆稻田、麦浪、飞蛾，想一生是多么失败，	回|忆|稻|田|、|麦|浪|、|飞|蛾|，|想|一|生|是|多|么|失|败|，	0
右手牵着夏尔	右|手|牵|着|夏|尔	0
好像极端也是一条旅途。	好|像|极|端|也|是|一|条|旅|途|。	1
像消逝的流星陨落天边。	像|消|逝|的|流|星|陨|落|天|边|。	1
如同纸张上的水印图案。	如|同|纸|张|上|的|水|印|图|案|。	1
仿佛在那回音犹响的春晨	仿|佛|在|那|回|音|犹|响|的|春|晨	1
就象大风已经远离这座城市	就|象|大|风|已|经|远|离|这|座|城|市	1
他仿佛根本没听见  沿轨道传来的震颤	他|仿|佛|根|本|没|听|见| | |沿|轨|道|传|来|的|震|颤	1
还剩、还剩最后一元话费，仿佛	还|剩|、|还|剩|最|后|一|元|话|费|，|仿|佛	1
我们有着仿佛是为白昼而诞生的头发。	我|们|有|着|仿|佛|是|为|白|昼|而|诞|生|的|头|发|。	1
那种感觉仿佛是	那|种|感|觉|仿|佛|是	1
它们就是这样引诱我去	它|们|就|是|这|样|引|诱|我|去	0
郑重其事得犹如精心装修过的房间	郑|重|其|事|得|犹|如|精|心|装|修|过|的|房|间	1
都将在早晨长大	都|将|在|早|晨|长|大	0
而且还挟着眼泪，夹着太息。	而|且|还|挟|着|眼|泪|，|夹|着|太|息|。	0
再不重要地或更加重要地，一定地	再|不|重|要|地|或|更|加|重|要|地|，|一|定|地	0
冰凉的词汇里，在一些	冰|凉|的|词|汇|里|，|在|一|些	0
生活如一杯茶，只有用心去品尝，才知道其中的滋味。	生|活|如|一|杯|茶|，|只|有|用|心|去|品|尝|，|才|知|道|其|中|的|滋|味|。	1
我觉得他挺讨厌	我|觉|得|他|挺|讨|厌	0
地瓜的藤蔓缠绕你丰满的心思	地|瓜|的|藤|蔓|缠|绕|你|丰|满|的|心|思	0
送往迎来，仿佛后世的风尘女子。	送|往|迎|来|，|仿|佛|后|世|的|风|尘|女|子|。	1
风花雪月的故事注定凄凉	风|花|雪|月|的|故|事|注|定|凄|凉	0
你富饶，你好似层层衣衫	你|富|饶|，|你|好|似|层|层|衣|衫	1
它的形状犹如一只熊熊燃烧的大桶一般；	它|的|形|状|犹|如|一|只|熊|熊|燃|烧|的|大|桶|一|般|；	1
骑士已越过盲人的视野	骑|士|已|越|过|盲|人|的|视|野	0
同样柔和而可爱。	同|样|柔|和|而|可|爱|。	2
在自我中好似身处锅炉。	在|自|我|中|好|似|身|处|锅|炉|。	1
[Title]就是沿着这条沉睡而混浊的河	[|T|i|t|l|e|]|就|是|沿|着|这|条|沉|睡|而|混|浊|的|河	2
象一瓣苹果，或一册	象|一|瓣|苹|果|，|或|一|册	1
那鸭梨又甜又香，咬一口脆生生的，甜水顺着下巴直流。	那|鸭|梨|又|甜|又|香|，|咬|一|口|脆|生|生|的|，|甜|水|顺|着|下|巴|直|流|。	1
我们几个人，除了我的情侣不加入	我|们|几|个|人|，|除|了|我|的|情|侣|不|加|入	0
白天他像一位圣人	白|天|他|像|一|位|圣|人	1
我永不收回去	我|永|不|收|回|去	0
黑发永远拖在脑后，象泛滥的柔情	黑|发|永|远|拖|在|脑|后|，|象|泛|滥|的|柔|情	1
――去	―|―|去	0
巨大的、胖胖的蝙蝠	巨|大|的|、|胖|胖|的|蝙|蝠	1
像晶莹的泪滴，	像|晶|莹|的|泪|滴|，	1
我替一种好味道来抚慰世上万物	我|替|一|种|好|味|道|来|抚|慰|世|上|万|物	1
更显示它们地位的突出	更|显|示|它|们|地|位|的|突|出	0
是的，也许我会宁静地走向寂灭，	是|的|，|也|许|我|会|宁|静|地|走|向|寂|灭|，	0
颓废地横在�髂�苍黄的夕阳的反照，	颓|废|地|横|在|�|髂|�|苍|黄|的|夕|阳|的|反|照|，	2
我们拍照，削苹果，吃梨，	我|们|拍|照|，|削|苹|果|，|吃|梨|，	0
黑树林毫无表情，代替风	黑|树|林|毫|无|表|情|，|代|替|风	0
群峰像一群伟大的教父	群|峰|像|一|群|伟|大|的|教|父	1
仿佛他们一直是	仿|佛|他|们|一|直|是	1
我们理应赞美，就像一切	我|们|理|应|赞|美|，|就|像|一|切	1
啊，你呀，眉毛好似深黛的弓，发鬈弯弯似花冠；	啊|，|你|呀|，|眉|毛|好|似|深|黛|的|弓|，|发|鬈|弯|弯|似|花|冠|；	1
如同纯洁的孩童静坐在学堂：	如|同|纯|洁|的|孩|童|静|坐|在|学|堂|：	1
千年仰望∶诗人思念故乡时题在天上的	千|年|仰|望|∶|诗|人|思|念|故|乡|时|题|在|天|上|的	0
你像黑色的风，在唱："我是你的人！"	你|像|黑|色|的|风|，|在|唱|：|"|我|是|你|的|人|！|"	1
收音机天天说个不停，令邻居十分厌恶!!!!!!	收|音|机|天|天|说|个|不|停|，|令|邻|居|十|分|厌|恶|!|!|!|!|!|!	2
音乐每每像大海一样使我入迷！	音|乐|每|每|像|大|海|一|样|使|我|入|迷|！	1
纤纤玉指在琴弦上滑动	纤|纤|玉|指|在|琴|弦|上|滑|动	0
就是那个停住劳动	就|是|那|个|停|住|劳|动	0
四周的生命仿佛突然塌下	四|周|的|生|命|仿|佛|突|然|塌|下	1
生死相搏。就象另一场海湾战争	生|死|相|搏|。|就|象|另|一|场|海|湾|战|争	1
低吟着各奔前程，好似姊妹双双	低|吟|着|各|奔|前|程|，|好|似|姊|妹|双|双	1
今天，太阳好害羞，躲在厚厚的云层后面，迟迟不肯露面。	今|天|，|太|阳|好|害|羞|，|躲|在|厚|厚|的|云|层|后|面|，|迟|迟|不|肯|露|面|。	2
它对我来说就像是风儿卷起的麦秸。我对麦秸同样重视。如果我想利	它|对|我|来|说|就|像|是|风|儿|卷|起|的|麦|秸|。|我|对|麦|秸|同|样|重|视|。|如|果|我|想|利	1
仿佛有物可以紧握、抓住，	仿|佛|有|物|可|以|紧|握|、|抓|住|，	1
肩扛锄镢  那把抒写语言的笔	肩|扛|锄|镢| | |那|把|抒|写|语|言|的|笔	0
如一支穿梭黑夜的电炬	如|一|支|穿|梭|黑|夜|的|电|炬	1
这断指常带了轻微又粘着的悲哀给我，	这|断|指|常|带|了|轻|微|又|粘|着|的|悲|哀|给|我|，	0
迟钝的肉体，沉重得像十月的草，	迟|钝|的|肉|体|，|沉|重|得|像|十|月|的|草|，	1
就象太阳暖我身心。	就|象|太|阳|暖|我|身|心|。	1
老狗学不会新把戏。他的筋斗云	老|狗|学|不|会|新|把|戏|。|他|的|筋|斗|云	0
她照耀着我，	她|照|耀|着|我|，	2
感觉已经不复存在	感|觉|已|经|不|复|存|在	0
她的凝视，仿佛雕像的凝视，	她|的|凝|视|，|仿|佛|雕|像|的|凝|视|，	1
为了不让手上的面包突然变成石头	为|了|不|让|手|上|的|面|包|突|然|变|成|石|头	2
一张张脸孔水一样掠过。	一|张|张|脸|孔|水|一|样|掠|过|。	1
像渔火一样暧昧而漂忽	像|渔|火|一|样|暧|昧|而|漂|忽	1
甚至更广。它就像是	甚|至|更|广|。|它|就|像|是	1
赐福露水、女性和果实。	赐|福|露|水|、|女|性|和|果|实|。	0
好似被人掐住喉咙，	好|似|被|人|掐|住|喉|咙|，	1
每棵树都是那么葱翠，谁也不高傲，谁也不自卑。	每|棵|树|都|是|那|么|葱|翠|，|谁|也|不|高|傲|，|谁|也|不|自|卑|。	2
它一定充满跳跃的鱼。	它|一|定|充|满|跳|跃|的|鱼|。	2
看着它们变成一群不断涨大的数字	看|着|它|们|变|成|一|群|不|断|涨|大|的|数|字	0
像是我的自性，我	像|是|我|的|自|性|，|我	1
仿佛他们才是城市真正的主人	仿|佛|他|们|才|是|城|市|真|正|的|主|人	1
最后的幻影	最|后|的|幻|影	0
鸟叫不定仿佛村子如一颗小鸟的嘴唇	鸟|叫|不|定|仿|佛|村|子|如|一|颗|小|鸟|的|嘴|唇	1
云彩像一朵朵皎白的茸毛，悄悄的飘浮在空中。	云|彩|像|一|朵|朵|皎|白|的|茸|毛|，|悄|悄|的|飘|浮|在|空|中|。	1
会不会在激烈战斗中阵亡？	会|不|会|在|激|烈|战|斗|中|阵|亡|？	2
就像那个朝向故居的山坡	就|像|那|个|朝|向|故|居|的|山|坡	1
自言自语  脚步缓慢  阳光轻抚旧桌椅	自|言|自|语| | |脚|步|缓|慢| | |阳|光|轻|抚|旧|桌|椅	0
犹如沿着鲜血染红的山谷流淌。	犹|如|沿|着|鲜|血|染|红|的|山|谷|流|淌|。	1
在戏耍时还会用翅膀	在|戏|耍|时|还|会|用|翅|膀	2
所给予的难以测算和重复的旋转力	所|给|予|的|难|以|测|算|和|重|复|的|旋|转|力	2
像是涉过一片片草地	像|是|涉|过|一|片|片|草|地	1
失去了自闭的能力	失|去|了|自|闭|的|能|力	1
在夏季松下的夜空发臭的子宫里。	在|夏|季|松|下|的|夜|空|发|臭|的|子|宫|里|。	1
也不知道萧萧落叶的悲叹	也|不|知|道|萧|萧|落|叶|的|悲|叹	0
像卑微的，无声地蠕动的蚂蚁	像|卑|微|的|，|无|声|地|蠕|动|的|蚂|蚁	1
像是从前某个夜晚遗落的微雨	像|是|从|前|某|个|夜|晚|遗|落|的|微|雨	1
紧紧的，冷冷的智慧和温柔的心田一般透明	紧|紧|的|，|冷|冷|的|智|慧|和|温|柔|的|心|田|一|般|透|明	2
像一个贫血的少女，像惊惶的初潮	像|一|个|贫|血|的|少|女|，|像|惊|惶|的|初|潮	1
温柔地抚摸大地，穿过美丽丰饶的园林	温|柔|地|抚|摸|大|地|，|穿|过|美|丽|丰|饶|的|园|林	2
喊着，——在这鸟儿勇敢的叫喊声里，乌云听到了欢乐。	喊|着|，|—|—|在|这|鸟|儿|勇|敢|的|叫|喊|声|里|，|乌|云|听|到|了|欢|乐|。	2
我的幻梦，犹如诡秘的面包的酵母，	我|的|幻|梦|，|犹|如|诡|秘|的|面|包|的|酵|母|，	1
它沮丧地得不到任何人青昧，	它|沮|丧|地|得|不|到|任|何|人|青|昧|，	2
像是倒霉的下岗工人。��	像|是|倒|霉|的|下|岗|工|人|。|�|�	1
我的倾诉带来你遥远的梦幻	我|的|倾|诉|带|来|你|遥|远|的|梦|幻	0
当我老了　窗前的的河水平流	当|我|老|了|　|窗|前|的|的|河|水|平|流	0
就像牛吃进了草	就|像|牛|吃|进|了|草	1
粗瓷大碗里盛着的  比苦楝子	粗|瓷|大|碗|里|盛|着|的| | |比|苦|楝|子	1
春天是一首美妙的乐曲，让世界充满音符;	春|天|是|一|首|美|妙|的|乐|曲|，|让|世|界|充|满|音|符|;	1
仿佛整个宇宙都伸出双手，	仿|佛|整|个|宇|宙|都|伸|出|双|手|，	1
犹如一个人往往为追踪小鸟	犹|如|一|个|人|往|往|为|追|踪|小|鸟	1
退到儿时乘坐的一趟列车，仿佛	退|到|儿|时|乘|坐|的|一|趟|列|车|，|仿|佛	1
如同鸟儿们回树上进窠巢。	如|同|鸟|儿|们|回|树|上|进|窠|巢|。	1
我感到剧痛，像摸到刚包扎好正变硬的	我|感|到|剧|痛|，|像|摸|到|刚|包|扎|好|正|变|硬|的	1
俯视飘浮的岛屿，宛如最后一枚	俯|视|飘|浮|的|岛|屿|，|宛|如|最|后|一|枚	1
没有人，只有我自己在这儿。对我，仿佛这一切	没|有|人|，|只|有|我|自|己|在|这|儿|。|对|我|，|仿|佛|这|一|切	1
取出我们的灵魂	取|出|我|们|的|灵|魂	0
沉闷的世界会不会窒息	沉|闷|的|世|界|会|不|会|窒|息	2
在肉体中好似埋入地窖。	在|肉|体|中|好|似|埋|入|地|窖|。	1
在这之前，他也并不曾睡卧，几乎像是麻木不仁；	在|这|之|前|，|他|也|并|不|曾|睡|卧|，|几|乎|像|是|麻|木|不|仁|；	1
而我好似五月的贵族。	而|我|好|似|五|月|的|贵|族|。	1
这就是孩子快乐的原则	这|就|是|孩|子|快|乐|的|原|则	0
像他整个身躯将挤进一只小木盒；	像|他|整|个|身|躯|将|挤|进|一|只|小|木|盒|；	1
仿佛当凄冷的夜晚轻抚姐妹苍白的脸颊。	仿|佛|当|凄|冷|的|夜|晚|轻|抚|姐|妹|苍|白|的|脸|颊|。	1
和新鲜的想法	和|新|鲜|的|想|法	0
像花朵那样安眠	像|花|朵|那|样|安|眠	1
赤裸着身体，在非神话的意义上	赤|裸|着|身|体|，|在|非|神|话|的|意|义|上	2
像磨坊的粉末，	像|磨|坊|的|粉|末|，	1
直到年岁把我带到海边。	直|到|年|岁|把|我|带|到|海|边|。	2
即使死亡，	即|使|死|亡|，	0
只要不暴露	只|要|不|暴|露	0
从船头传到船尾，仿佛	从|船|头|传|到|船|尾|，|仿|佛	1
仿佛我的手卡住了喉咙……	仿|佛|我|的|手|卡|住|了|喉|咙|…|…	1
一面镜子可以称作是一位多年忠实的友人	一|面|镜|子|可|以|称|作|是|一|位|多|年|忠|实|的|友|人	0
就象俘虏，饥饿中梦想着，	就|象|俘|虏|，|饥|饿|中|梦|想|着|，	1
就象装饰盛放圣骨的神柜，	就|象|装|饰|盛|放|圣|骨|的|神|柜|，	1
这好似一段古老的传说半已销声；	这|好|似|一|段|古|老|的|传|说|半|已|销|声|；	1
双手能抓住的东西才是事物的本质	双|手|能|抓|住|的|东|西|才|是|事|物|的|本|质	0
以及绿色的乳房和青铜	以|及|绿|色|的|乳|房|和|青|铜	2
在雷鸣与闪电之中,投下了	在|雷|鸣|与|闪|电|之|中|,|投|下|了	1
跑进苍茫的雪中，像一株更弱的	跑|进|苍|茫|的|雪|中|，|像|一|株|更|弱|的	1
瞳孔却被拽了回去	瞳|孔|却|被|拽|了|回|去	0
人们象一只只蠕动的幼虫	人|们|象|一|只|只|蠕|动|的|幼|虫	1
把她从追逐自己的阴影的恐怖中拯救出来吧，	把|她|从|追|逐|自|己|的|阴|影|的|恐|怖|中|拯|救|出|来|吧|，	2
冷枪是不可能的了，冷兵器时代，	冷|枪|是|不|可|能|的|了|，|冷|兵|器|时|代|，	0
寄与爱和一切希望，	寄|与|爱|和|一|切|希|望|，	0
象一只巨大的纸鸢	象|一|只|巨|大|的|纸|鸢	1
都将被无言的声音粉碎！	都|将|被|无|言|的|声|音|粉|碎|！	0
此地展示寂静中忙碌的生命。	此|地|展|示|寂|静|中|忙|碌|的|生|命|。	2
你把自己建在肉体的沼泽上	你|把|自|己|建|在|肉|体|的|沼|泽|上	0
象乱雪落地扰乱着哀思	象|乱|雪|落|地|扰|乱|着|哀|思	1
它带来启示，七颗星，羽林军的荣光	它|带|来|启|示|，|七|颗|星|，|羽|林|军|的|荣|光	0
花瓣上有颤栗的露水	花|瓣|上|有|颤|栗|的|露|水	2
仿佛意外的东西就要降临	仿|佛|意|外|的|东|西|就|要|降|临	0
哦，身体里拥挤不堪，好像有人上车，	哦|，|身|体|里|拥|挤|不|堪|，|好|像|有|人|上|车|，	1
赶在讲话之前	赶|在|讲|话|之|前	0
欢乐去迎接凌晨。	欢|乐|去|迎|接|凌|晨|。	2
你看亲爱的	你|看|亲|爱|的	0
比聚敛废钢铁的空场还要空旷	比|聚|敛|废|钢|铁|的|空|场|还|要|空|旷	0
流淌进自己的身体	流|淌|进|自|己|的|身|体	2
让我来将它们注满，照顾她的生意	让|我|来|将|它|们|注|满|，|照|顾|她|的|生|意	0
当大自然向我提出这一要求时，	当|大|自|然|向|我|提|出|这|一|要|求|时|，	2
被深深地埋在地里	被|深|深|地|埋|在|地|里	0
列车也仿佛轻快了许多	列|车|也|仿|佛|轻|快|了|许|多	1
仓皇逃窜，	仓|皇|逃|窜|，	2
像一首小令	像|一|首|小|令	1
好像一大片火奔腾在远方	好|像|一|大|片|火|奔|腾|在|远|方	1
一项宪法修正案中还规定，	一|项|宪|法|修|正|案|中|还|规|定|，	0
情和倾心。几乎像以扫一样（参阅《创世记》第二十七	情|和|倾|心|。|几|乎|像|以|扫|一|样|（|参|阅|《|创|世|记|》|第|二|十|七	1
像注视着你的睡梦拢在	像|注|视|着|你|的|睡|梦|拢|在	1
四月阴天里，你先露笑容，	四|月|阴|天|里|，|你|先|露|笑|容|，	2
你的爱宛如游丝一绺。	你|的|爱|宛|如|游|丝|一|绺|。	1
地里弯腰的农妇拾起最后的落穗，这时没有牛羊	地|里|弯|腰|的|农|妇|拾|起|最|后|的|落|穗|，|这|时|没|有|牛|羊	0
天空在云隙间多么喜悦，	天|空|在|云|隙|间|多|么|喜|悦|，	2
桃花凋谢了，枝头残留着几片花瓣，仍像点点跳动的火苗。	桃|花|凋|谢|了|，|枝|头|残|留|着|几|片|花|瓣|，|仍|像|点|点|跳|动|的|火|苗|。	1
唱着火热的歌迎接她的情人：	唱|着|火|热|的|歌|迎|接|她|的|情|人|：	2
不不，当慈禧下令开凿昆玉河接通昆明湖	不|不|，|当|慈|禧|下|令|开|凿|昆|玉|河|接|通|昆|明|湖	0
初次看到你，一声忧郁的长叹，好似你那甜美微风的呢喃，掠过深深	初|次|看|到|你|，|一|声|忧|郁|的|长|叹|，|好|似|你|那|甜|美|微|风|的|呢|喃|，|掠|过|深|深	1
喜欢它碰触玻璃光滑的肌肤	喜|欢|它|碰|触|玻|璃|光|滑|的|肌|肤	2
象天使那样的	象|天|使|那|样|的	1
两粒赖在烤羊腿上的葡萄干醒来了	两|粒|赖|在|烤|羊|腿|上|的|葡|萄|干|醒|来|了	2
默然消失在冷漠的太空。”	默|然|消|失|在|冷|漠|的|太|空|。|”	2
和水仙一同翩翩起舞。	和|水|仙|一|同|翩|翩|起|舞|。	2
只能在沉默中劳作，在无声中表达。	只|能|在|沉|默|中|劳|作|，|在|无|声|中|表|达|。	0
梳理着柔软如丝的发辫。	梳|理|着|柔|软|如|丝|的|发|辫|。	2
渡过了艰难。	渡|过|了|艰|难|。	0
我真怕有一天她累倒在终点。	我|真|怕|有|一|天|她|累|倒|在|终|点|。	0
胶、石油、钢铁，下水道里的残羹冷灸，洗头妹粗鲁	胶|、|石|油|、|钢|铁|，|下|水|道|里|的|残|羹|冷|灸|，|洗|头|妹|粗|鲁	0
那一个的黑夜是白天	那|一|个|的|黑|夜|是|白|天	0
但我猜想这一定是一段悲哀的事，	但|我|猜|想|这|一|定|是|一|段|悲|哀|的|事|，	0
绽开笑脸的花朵不表现我的土地	绽|开|笑|脸|的|花|朵|不|表|现|我|的|土|地	2
男人的皮肤绷紧得象一面面鼓	男|人|的|皮|肤|绷|紧|得|象|一|面|面|鼓	1
畸形，在某个未名夜已沦为盆地	畸|形|，|在|某|个|未|名|夜|已|沦|为|盆|地	0
让不连贯的音符象孢子	让|不|连|贯|的|音|符|象|孢|子	1
你们又象小鸟折断了翅膀，	你|们|又|象|小|鸟|折|断|了|翅|膀|，	1
我新买的音箱里有一个会按摩的女鬼	我|新|买|的|音|箱|里|有|一|个|会|按|摩|的|女|鬼	0
你绝对的静止，	你|绝|对|的|静|止|，	0
已经没有多少时间排练。仿佛	已|经|没|有|多|少|时|间|排|练|。|仿|佛	1
你的沉默有如星星，遥远而又沉静。	你|的|沉|默|有|如|星|星|，|遥|远|而|又|沉|静|。	1
健康、欢笑、矫捷而行，	健|康|、|欢|笑|、|矫|捷|而|行|，	2
上升。冬天的太阳到达了顶端	上|升|。|冬|天|的|太|阳|到|达|了|顶|端	0
音乐大踏步走来，向阳光挑战，	音|乐|大|踏|步|走|来|，|向|阳|光|挑|战|，	2
像故去一样	像|故|去|一|样	0
当时是蔚蓝的，仿佛是从天空中流下，	当|时|是|蔚|蓝|的|，|仿|佛|是|从|天|空|中|流|下|，	1
迷漠地怀想着，不做声，也不流泪！	迷|漠|地|怀|想|着|，|不|做|声|，|也|不|流|泪|！	0
够了。让我享有缄默。	够|了|。|让|我|享|有|缄|默|。	0
下雨的日子穿着鲜艳的雨衣	下|雨|的|日|子|穿|着|鲜|艳|的|雨|衣	2
别再像软绵绵长笛，	别|再|像|软|绵|绵|长|笛|，	1
就像从海底深处出浴后的太阳，①	就|像|从|海|底|深|处|出|浴|后|的|太|阳|，|①	1
运动员像离弦的箭一般向终点跑去。	运|动|员|像|离|弦|的|箭|一|般|向|终|点|跑|去|。	1
但往往忽略了你的十载《沧桑》	但|往|往|忽|略|了|你|的|十|载|《|沧|桑|》	0
爱情是充满烦恼的喜悦，	爱|情|是|充|满|烦|恼|的|喜|悦|，	2
也仿佛有许多扇门挡住我	也|仿|佛|有|许|多|扇|门|挡|住|我	1
火是可畅饮的�G	火|是|可|畅|饮|的|�|G	0
曲低唱出来。	曲|低|唱|出|来|。	2
就瞅着那像，宛如你在我眼前一样，	就|瞅|着|那|像|，|宛|如|你|在|我|眼|前|一|样|，	1
仿佛他们的先生的方式	仿|佛|他|们|的|先|生|的|方|式	1
仿佛蘸满了香炉的热气。	仿|佛|蘸|满|了|香|炉|的|热|气|。	1
没有睡眠的人都象是破箩筐	没|有|睡|眠|的|人|都|象|是|破|箩|筐	1
风的手时而有力地伸出，	风|的|手|时|而|有|力|地|伸|出|，	2
如果爱情好似生命，我的亲人，	如|果|爱|情|好|似|生|命|，|我|的|亲|人|，	1
在肉体内如同圈进牛栏，	在|肉|体|内|如|同|圈|进|牛|栏|，	1
春天像小姑娘，花枝招展的，笑着，走着。	春|天|像|小|姑|娘|，|花|枝|招|展|的|，|笑|着|，|走|着|。	1
欢乐不会常驻，谁知道明朝将会怎样！	欢|乐|不|会|常|驻|，|谁|知|道|明|朝|将|会|怎|样|！	2
爱情拥抱了欢乐的全部意象，	爱|情|拥|抱|了|欢|乐|的|全|部|意|象|，	2
是因为在树的呻吟，夜的叹息中	是|因|为|在|树|的|呻|吟|，|夜|的|叹|息|中	2
风翻开了书！	风|翻|开|了|书|！	2
觉美感，也能享受像聆听一支优美的乐曲时的听觉美感。	觉|美|感|，|也|能|享|受|像|聆|听|一|支|优|美|的|乐|曲|时|的|听|觉|美|感|。	1
所有轨迹消失，像船沉没在，	所|有|轨|迹|消|失|，|像|船|沉|没|在|，	1
因为不时地仿佛有一种预感	因|为|不|时|地|仿|佛|有|一|种|预|感	1
在云雾的裂纹里，我看见了一片腾起的，像梦。	在|云|雾|的|裂|纹|里|，|我|看|见|了|一|片|腾|起|的|，|像|梦|。	1
锯木场寂寞的仓房	锯|木|场|寂|寞|的|仓|房	0
像闪电，劈开了泡桐潮湿的躯干	像|闪|电|，|劈|开|了|泡|桐|潮|湿|的|躯|干	1
也并不温和地走进那个良夜。	也|并|不|温|和|地|走|进|那|个|良|夜|。	2
夜晚轻轻撩开你心思的风儿	夜|晚|轻|轻|撩|开|你|心|思|的|风|儿	0
是空无，绵延，更亮的寂静	是|空|无|，|绵|延|，|更|亮|的|寂|静	1
象小河边上的绣球花。	象|小|河|边|上|的|绣|球|花|。	1
使我能承受它的照射，它竟像是朝我们这边移动”。	使|我|能|承|受|它|的|照|射|，|它|竟|像|是|朝|我|们|这|边|移|动|”|。	1
像是在那开始有盲目的鱼	像|是|在|那|开|始|有|盲|目|的|鱼	1
我随即转过身去，犹如一个人	我|随|即|转|过|身|去|，|犹|如|一|个|人	1
你走吧，爱还没有烧完	你|走|吧|，|爱|还|没|有|烧|完	0
好像恫吓人们，在编队飞行，	好|像|恫|吓|人|们|，|在|编|队|飞|行|，	1
正如一把利刃插在我的心灵	正|如|一|把|利|刃|插|在|我|的|心|灵	1
街灯象一支残烛，	街|灯|象|一|支|残|烛|，	1
如拍岸的浪花要磨光一颗卵石	如|拍|岸|的|浪|花|要|磨|光|一|颗|卵|石	1
听起来像是在下雨；	听|起|来|像|是|在|下|雨|；	1
它们静静地睡在那儿，	它|们|静|静|地|睡|在|那|儿|，	2
也只能慢慢消退，渐渐消失，	也|只|能|慢|慢|消|退|，|渐|渐|消|失|，	0
冗长的岁月里  让我忘却	冗|长|的|岁|月|里| | |让|我|忘|却	0
像黑笛手们野餐时吹奏这笛声。	像|黑|笛|手|们|野|餐|时|吹|奏|这|笛|声|。	1
黑色的头发，你就是火焰和波浪。	黑|色|的|头|发|，|你|就|是|火|焰|和|波|浪|。	1
停着三只乌鸫。	停|着|三|只|乌|鸫|。	1
你那绯红的面颊，犹如普照寰宇的太阳；	你|那|绯|红|的|面|颊|，|犹|如|普|照|寰|宇|的|太|阳|；	1
我像急躁的农夫揠高火苗──	我|像|急|躁|的|农|夫|揠|高|火|苗|─|─	1
空气也仿佛吓得索索抖动。	空|气|也|仿|佛|吓|得|索|索|抖|动|。	1
对面的阳台常常发出一种声音	对|面|的|阳|台|常|常|发|出|一|种|声|音	0
几只乌鸦在积雪中打开翅膀	几|只|乌|鸦|在|积|雪|中|打|开|翅|膀	0
忙碌的蜜蜂在花丛中穿梭，那是在教我们勤劳。	忙|碌|的|蜜|蜂|在|花|丛|中|穿|梭|，|那|是|在|教|我|们|勤|劳|。	2
两个小时后你将起床	两|个|小|时|后|你|将|起|床	0
当它抚摸万物的温柔手指	当|它|抚|摸|万|物|的|温|柔|手|指	2
仿佛随时会大笑起来	仿|佛|随|时|会|大|笑|起|来	1
在车里冷得发抖	在|车|里|冷|得|发|抖	0
他是我看见的第一个背影	他|是|我|看|见|的|第|一|个|背|影	0
仿佛过去我们谁也不曾到过这里	仿|佛|过|去|我|们|谁|也|不|曾|到|过|这|里	1
听见摇动的池塘在低语	听|见|摇|动|的|池|塘|在|低|语	2
每张帆更白得像是牛奶——	每|张|帆|更|白|得|像|是|牛|奶|—|—	1
也有无限的能力与优美可钦的仪表。其举止就如天使,灵性可媲神仙。	也|有|无|限|的|能|力|与|优|美|可|钦|的|仪|表|。|其|举|止|就|如|天|使|,|灵|性|可|媲|神|仙|。	2
用它们自己的脚踩高跷的细脚鸟，	用|它|们|自|己|的|脚|踩|高|跷|的|细|脚|鸟|，	2
请打开那栅栏的门扇	请|打|开|那|栅|栏|的|门|扇	0
而我恰是个修补圩堤的人。	而|我|恰|是|个|修|补|圩|堤|的|人|。	0
史诗那古老嗓音的召唤。	史|诗|那|古|老|嗓|音|的|召|唤|。	2
再者，如果“时间”，[2.世界也不会再被充满；]	再|者|，|如|果|“|时|间|”|，|[|2|.|世|界|也|不|会|再|被|充|满|；|]	2
戴大红帽的飞亭	戴|大|红|帽|的|飞|亭	0
这一滴血，这是她生命行将枯竭时的	这|一|滴|血|，|这|是|她|生|命|行|将|枯|竭|时|的	0
蛇，从名叫伯艮第的酒里吐出舌头	蛇|，|从|名|叫|伯|艮|第|的|酒|里|吐|出|舌|头	0
走吧，越走越远	走|吧|，|越|走|越|远	0
犹如统治一个姑娘好年轻。	犹|如|统|治|一|个|姑|娘|好|年|轻|。	1
拖船的回声如同布匹	拖|船|的|回|声|如|同|布|匹	1
站着，就象当年等我在镇边，	站|着|，|就|象|当|年|等|我|在|镇|边|，	1
随时会像婴儿一样哭出声来。�オ�	随|时|会|像|婴|儿|一|样|哭|出|声|来|。|�|オ|�	1
只要我的爱人	只|要|我|的|爱|人	1
傍晚，六点，“众客来”餐馆。我们像一阵风，从楼房，	傍|晚|，|六|点|，|“|众|客|来|”|餐|馆|。|我|们|像|一|阵|风|，|从|楼|房|，	1
谁的允诺，像明信片一样虚假	谁|的|允|诺|，|像|明|信|片|一|样|虚|假	1
比如头发与日历	比|如|头|发|与|日|历	0
他就好像长在马鞍上一般,演出了一些令人不可思议的技巧,	他|就|好|像|长|在|马|鞍|上|一|般|,|演|出|了|一|些|令|人|不|可|思|议|的|技|巧|,	1
不像是她的手	不|像|是|她|的|手	1
明朝的建立者朱元璋至今身世不明：	明|朝|的|建|立|者|朱|元|璋|至|今|身|世|不|明|：	0
哈罗，我英勇的好似携着一支长笛的鸽子！	哈|罗|，|我|英|勇|的|好|似|携|着|一|支|长|笛|的|鸽|子|！	1
就好像在寻找有真理的	就|好|像|在|寻|找|有|真|理|的	1
鸟儿们掠过，逃跑般地。	鸟|儿|们|掠|过|，|逃|跑|般|地|。	2
有一位神忽然叫起来了＿＿“光链里仿佛断了一环，一颗星星走失了。"	有|一|位|神|忽|然|叫|起|来|了|＿|＿|“|光|链|里|仿|佛|断|了|一|环|，|一|颗|星|星|走|失|了|。|"	1
真理，像扩散的癌细胞一样，	真|理|，|像|扩|散|的|癌|细|胞|一|样|，	1
仿佛一面破旧的镜子，仿佛独门独户的气味，	仿|佛|一|面|破|旧|的|镜|子|，|仿|佛|独|门|独|户|的|气|味|，	1
唉！打那时刻起，我仿佛掉了魂似地，	唉|！|打|那|时|刻|起|，|我|仿|佛|掉|了|魂|似|地|，	1
它便对我来作密切的拜访。	它|便|对|我|来|作|密|切|的|拜|访|。	0
就像对我的生命。一片白茫茫的雾气	就|像|对|我|的|生|命|。|一|片|白|茫|茫|的|雾|气	1
向日葵不断地面向太阳公公做户外。	向|日|葵|不|断|地|面|向|太|阳|公|公|做|户|外|。	2
倚着窗台，瞌睡连天	倚|着|窗|台|，|瞌|睡|连|天	0
我来到一个美丽地方	我|来|到|一|个|美|丽|地|方	0
觉美感，也能享受像聆听一支优美的乐曲时的听觉美感。	觉|美|感|，|也|能|享|受|像|聆|听|一|支|优|美|的|乐|曲|时|的|听|觉|美|感|。	1
恋爱就像智力竞赛，规则能够设置无数，但有1条却一向去不掉，那就是：去掉一个最高分，去掉一个最低分―-最高分总是被优先淘汰。	恋|爱|就|像|智|力|竞|赛|，|规|则|能|够|设|置|无|数|，|但|有|1|条|却|一|向|去|不|掉|，|那|就|是|：|去|掉|一|个|最|高|分|，|去|掉|一|个|最|低|分|―|-|最|高|分|总|是|被|优|先|淘|汰|。	1
或水流索取。仿佛远古的圣殿	或|水|流|索|取|。|仿|佛|远|古|的|圣|殿	1
春天像一位散花仙子，把大地装点得像一座花园。	春|天|像|一|位|散|花|仙|子|，|把|大|地|装|点|得|像|一|座|花|园|。	1
枕在光明的膝头睡过了一觉。	枕|在|光|明|的|膝|头|睡|过|了|一|觉|。	2
象一把火还在燃烧	象|一|把|火|还|在|燃|烧	1
此刻那张口隆起，仿佛知晓一切——	此|刻|那|张|口|隆|起|，|仿|佛|知|晓|一|切|—|—	1
我是在独自的生活中听到了你	我|是|在|独|自|的|生|活|中|听|到|了|你	0
她仿佛一个幽灵。	她|仿|佛|一|个|幽|灵|。	1
我们的影子和夜晚	我|们|的|影|子|和|夜|晚	0
仿佛是，在空气中，在尘霾里，	仿|佛|是|，|在|空|气|中|，|在|尘|霾|里|，	1
像是无纪录的帝室的更换。	像|是|无|纪|录|的|帝|室|的|更|换|。	1
餐饱了纸屑酒瓶的垃圾箱静候	餐|饱|了|纸|屑|酒|瓶|的|垃|圾|箱|静|候	2
时间的鬣狗在大地的面包上狂奔，��	时|间|的|鬣|狗|在|大|地|的|面|包|上|狂|奔|，|�|�	1
你的话语是叶尖上	你|的|话|语|是|叶|尖|上	1
母亲是天边的启明星，总是早早地起来忙碌。	母|亲|是|天|边|的|启|明|星|，|总|是|早|早|地|起|来|忙|碌|。	1
今天我是柔和的风，像溪水流动，	今|天|我|是|柔|和|的|风|，|像|溪|水|流|动|，	1
望着光像海草或风轻易地穿过	望|着|光|像|海|草|或|风|轻|易|地|穿|过	1
情人似的阿妹  你日夜思念	情|人|似|的|阿|妹| | |你|日|夜|思|念	0
多少次：写信就像是	多|少|次|：|写|信|就|像|是	1
优美的时刻：上帝所喜欢！	优|美|的|时|刻|：|上|帝|所|喜|欢|！	2
（理想）说明美的两面性。大理石像是永恒的，不动的，	（|理|想|）|说|明|美|的|两|面|性|。|大|理|石|像|是|永|恒|的|，|不|动|的|，	1
细长的小巷像是一支洞箫，	细|长|的|小|巷|像|是|一|支|洞|箫|，	1
坐在明亮温暖的开满鲜花的山坡上。	坐|在|明|亮|温|暖|的|开|满|鲜|花|的|山|坡|上|。	2
像是无纪录的帝室的更换。	像|是|无|纪|录|的|帝|室|的|更|换|。	1
常常是这时候我会忘记时间的流动	常|常|是|这|时|候|我|会|忘|记|时|间|的|流|动	0
诗歌的形式仿佛很难带来更大的满足，刻意	诗|歌|的|形|式|仿|佛|很|难|带|来|更|大|的|满|足|，|刻|意	1
仿佛被供奉在祭坛	仿|佛|被|供|奉|在|祭|坛	1
可是手只抄写它所学到的记号。	可|是|手|只|抄|写|它|所|学|到|的|记|号|。	2
她为什么能生下另外三个儿子时，她说：	她|为|什|么|能|生|下|另|外|三|个|儿|子|时|，|她|说|：	0
画十字以祝福，当我独立于这童年的街边	画|十|字|以|祝|福|，|当|我|独|立|于|这|童|年|的|街|边	0
40那颗能够和欢乐的心一同唱出欢歌的忧愁的心，是多么高贵呵。	4|0|那|颗|能|够|和|欢|乐|的|心|一|同|唱|出|欢|歌|的|忧|愁|的|心|，|是|多|么|高|贵|呵|。	2
水仙的炯炯明眸凝望着盛开的郁金香。	水|仙|的|炯|炯|明|眸|凝|望|着|盛|开|的|郁|金|香|。	2
像黄昏之中消逝的花园	像|黄|昏|之|中|消|逝|的|花|园	1
五个以上辅音聚会就是非法。	五|个|以|上|辅|音|聚|会|就|是|非|法|。	0
却仿佛只有它本身在痛苦号啕；	却|仿|佛|只|有|它|本|身|在|痛|苦|号|啕|；	1
一个在吉它上闲逛的朋友给我留了张字条	一|个|在|吉|它|上|闲|逛|的|朋|友|给|我|留|了|张|字|条	0
歌唱吧，就象珍珠母在睡觉或呼吸。	歌|唱|吧|，|就|象|珍|珠|母|在|睡|觉|或|呼|吸|。	1
我听说过那些音乐，犹如	我|听|说|过|那|些|音|乐|，|犹|如	1
它好似下沉与升高各占一半；	它|好|似|下|沉|与|升|高|各|占|一|半|；	1
白色的泡沫，仿佛受创的雪之时，	白|色|的|泡|沫|，|仿|佛|受|创|的|雪|之|时|，	1
像是要结识我一般。	像|是|要|结|识|我|一|般|。	1
仿佛从我们的身体上碾过	仿|佛|从|我|们|的|身|体|上|碾|过	1
正宗的八角胡椒道地的酱油老蔡	正|宗|的|八|角|胡|椒|道|地|的|酱|油|老|蔡	0
连绵不绝，如繁星灿烂，	连|绵|不|绝|，|如|繁|星|灿|烂|，	1
才能看到逃离的李红努努嘴好像一个吻	才|能|看|到|逃|离|的|李|红|努|努|嘴|好|像|一|个|吻	0
菩提树白白地招手，	菩|提|树|白|白|地|招|手|，	2
像小镇上的先知，��	像|小|镇|上|的|先|知|，|�|�	1
想召回已经逝去的年华，	想|召|回|已|经|逝|去|的|年|华|，	0
我在你们不知道的地方感到空虚	我|在|你|们|不|知|道|的|地|方|感|到|空|虚	0
仿佛电影里的休格兰特羞涩地摸向"咪咪"的船舱。	仿|佛|电|影|里|的|休|格|兰|特|羞|涩|地|摸|向|"|咪|咪|"|的|船|舱|。	0
继续生长，仿佛并不缺少阳光和	继|续|生|长|，|仿|佛|并|不|缺|少|阳|光|和	1
听着这猫儿在炉边打盹；	听|着|这|猫|儿|在|炉|边|打|盹|；	0
像有一窝悬空的蚁冢，	像|有|一|窝|悬|空|的|蚁|冢|，	1
不会比梁赞的沃野更可爱。	不|会|比|梁|赞|的|沃|野|更|可|爱|。	2
他们像儿童渴望彩奴那样渴望流泪。	他|们|像|儿|童|渴|望|彩|奴|那|样|渴|望|流|泪|。	1
啊！让罪恶象子宫一样	啊|！|让|罪|恶|象|子|宫|一|样	1
仿佛心魂和嘴唇在互相召唤，	仿|佛|心|魂|和|嘴|唇|在|互|相|召|唤|，	1
岩石的嶙峋呈现她哺育时序的苦痛	岩|石|的|嶙|峋|呈|现|她|哺|育|时|序|的|苦|痛	2
看不见他们，就像我看不见自己的面孔	看|不|见|他|们|，|就|像|我|看|不|见|自|己|的|面|孔	1
可心底留下了一眼欢乐之泉，	可|心|底|留|下|了|一|眼|欢|乐|之|泉|，	2
创造好，他们跟我们相仿佛，虽然	创|造|好|，|他|们|跟|我|们|相|仿|佛|，|虽|然	1
那独一无二的花纹，那种痛苦，仿佛遭受刑讯。	那|独|一|无|二|的|花|纹|，|那|种|痛|苦|，|仿|佛|遭|受|刑|讯|。	1
四处是亭台的摆设和越女的清唱	四|处|是|亭|台|的|摆|设|和|越|女|的|清|唱	0
好像已将我们，搂进了	好|像|已|将|我|们|，|搂|进|了	1
这时的燕子轻轻地掠过水面，	这|时|的|燕|子|轻|轻|地|掠|过|水|面|，	0
你拧灭的烟蒂奄奄一息	你|拧|灭|的|烟|蒂|奄|奄|一|息	2
夜晚走回恋人的身边	夜|晚|走|回|恋|人|的|身|边	0
生命和信念，	生|命|和|信|念|，	0
本来就充满了悲伤	本|来|就|充|满|了|悲|伤	2
我从人群中剥离出来，仿佛针头抽离血管	我|从|人|群|中|剥|离|出|来|，|仿|佛|针|头|抽|离|血|管	1
就象恋爱始终都在躲避	就|象|恋|爱|始|终|都|在|躲|避	1
阳光照着高大的墙壁光华耀眼。	阳|光|照|着|高|大|的|墙|壁|光|华|耀|眼|。	2
像初夏的雷霆滚过阴云密布的天空	像|初|夏|的|雷|霆|滚|过|阴|云|密|布|的|天|空	1
把你的玻璃窗轻拍；	把|你|的|玻|璃|窗|轻|拍|；	2
透明是一种神秘的、能看见波浪的语言，	透|明|是|一|种|神|秘|的|、|能|看|见|波|浪|的|语|言|，	2
在起风的黄昏五点半	在|起|风|的|黄|昏|五|点|半	0
象微风经过黑暗的邃道	象|微|风|经|过|黑|暗|的|邃|道	1
蚊子舰队上下左右优雅地移动	蚊|子|舰|队|上|下|左|右|优|雅|地|移|动	0
还有一个爱钓鱼的硬汉。	还|有|一|个|爱|钓|鱼|的|硬|汉|。	0
学会呼吸。我像一只打开的河蚌	学|会|呼|吸|。|我|像|一|只|打|开|的|河|蚌	1
就像一种顽强可怕的蘑菇	就|像|一|种|顽|强|可|怕|的|蘑|菇	1
就仿佛是帆樯桨橹无数，	就|仿|佛|是|帆|樯|桨|橹|无|数|，	1
不会害怕一种感受不到的事物，殊不知	不|会|害|怕|一|种|感|受|不|到|的|事|物|，|殊|不|知	2
梦想中的未来的神庙——然后，是那颤音，犹如喷泉，	梦|想|中|的|未|来|的|神|庙|—|—|然|后|，|是|那|颤|音|，|犹|如|喷|泉|，	1
只是犹如睡梦中的一声惊呼。	只|是|犹|如|睡|梦|中|的|一|声|惊|呼|。	1
嬉戏，且相互追逐	嬉|戏|，|且|相|互|追|逐	2
被踏成灰烬的开垦者	被|踏|成|灰|烬|的|开|垦|者	0
象一朵盛开的罂粟	象|一|朵|盛|开|的|罂|粟	1
三十五岁了，既没有星光，也没有云	三|十|五|岁|了|，|既|没|有|星|光|，|也|没|有|云	0
第一桩事：在充满清新、熹微光亮的小径上，一朵	第|一|桩|事|：|在|充|满|清|新|、|熹|微|光|亮|的|小|径|上|，|一|朵	2
怀着一腔虚妄的激情，在不同的屋顶下	怀|着|一|腔|虚|妄|的|激|情|，|在|不|同|的|屋|顶|下	1
仿佛天穹并不那么高深。	仿|佛|天|穹|并|不|那|么|高|深|。	1
白日的泉水流向大海  在赤裸的	白|日|的|泉|水|流|向|大|海| | |在|赤|裸|的	0
月光和神秘在此挥洒。	月|光|和|神|秘|在|此|挥|洒|。	2
黑浪就来将我温柔地覆盖	黑|浪|就|来|将|我|温|柔|地|覆|盖	0
在夜深人静的倾听中她向我索要服务费	在|夜|深|人|静|的|倾|听|中|她|向|我|索|要|服|务|费	0
他们像动物一样忍饥受渴，	他|们|像|动|物|一|样|忍|饥|受|渴|，	1
宛如一滴水与无数滴水的媾和	宛|如|一|滴|水|与|无|数|滴|水|的|媾|和	1
渡口的河水柔和地拍击	渡|口|的|河|水|柔|和|地|拍|击	2
失去欢乐，何必唤醒这阴沉的一年？	失|去|欢|乐|，|何|必|唤|醒|这|阴|沉|的|一|年|？	2
过来，过来呀！藏起来就能够奔跑	过|来|，|过|来|呀|！|藏|起|来|就|能|够|奔|跑	0
叫过我的名字，象人们相识时	叫|过|我|的|名|字|，|象|人|们|相|识|时	1
仿佛，你肩负着使命，	仿|佛|，|你|肩|负|着|使|命|，	1
拦截的蜡烛；又象在风中	拦|截|的|蜡|烛|；|又|象|在|风|中	1
它只是一种永不两次重复	它|只|是|一|种|永|不|两|次|重|复	0
一起来享受青年们的狂欢；	一|起|来|享|受|青|年|们|的|狂|欢|；	2
击碎了你太多情太温柔孩子般的胸膛，	击|碎|了|你|太|多|情|太|温|柔|孩|子|般|的|胸|膛|，	1
好像该草签一张有关未来的时间表。	好|像|该|草|签|一|张|有|关|未|来|的|时|间|表|。	1
而且－仿佛迷雾已浸透了我们－	而|且|－|仿|佛|迷|雾|已|浸|透|了|我|们|－	1
仿佛禁鞭以后过剩的家族亲情	仿|佛|禁|鞭|以|后|过|剩|的|家|族|亲|情	1
泥土的路。我相信几十年以后同样会有一个和我	泥|土|的|路|。|我|相|信|几|十|年|以|后|同|样|会|有|一|个|和|我	0
关于童年，她记恨童年	关|于|童|年|，|她|记|恨|童|年	0
鸟叫不定, 仿佛村子如一颗小鸟的嘴唇	鸟|叫|不|定|,| |仿|佛|村|子|如|一|颗|小|鸟|的|嘴|唇	1
好似宇宙今天刚刚诞生	好|似|宇|宙|今|天|刚|刚|诞|生	1
于是就想到结婚	于|是|就|想|到|结|婚	0
那样的娇嫩可爱而鲜艳，	那|样|的|娇|嫩|可|爱|而|鲜|艳|，	2
但我的精液混合有你的经血――	但|我|的|精|液|混|合|有|你|的|经|血|―|―	0
就好像从心中吐出清晨的光亮似的	就|好|像|从|心|中|吐|出|清|晨|的|光|亮|似|的	1
轻易褪下	轻|易|褪|下	0
树干的树木不可计数，如一把撑开的大伞，真是一株大树啊。	树|干|的|树|木|不|可|计|数|，|如|一|把|撑|开|的|大|伞|，|真|是|一|株|大|树|啊|。	1
就是你歇息的地方，那里兄弟牵手，姐妹团圆	就|是|你|歇|息|的|地|方|，|那|里|兄|弟|牵|手|，|姐|妹|团|圆	0
重复一席温存的话语	重|复|一|席|温|存|的|话|语	1
仿佛低缓的钟鸣时伏时起。	仿|佛|低|缓|的|钟|鸣|时|伏|时|起|。	1
或者一角衣裳的爱恋是无希望的。	或|者|一|角|衣|裳|的|爱|恋|是|无|希|望|的|。	0
就瞅着那像，宛如你在我眼前一样，	就|瞅|着|那|像|，|宛|如|你|在|我|眼|前|一|样|，	1
仿佛一只酩酊的蜜蜂。	仿|佛|一|只|酩|酊|的|蜜|蜂|。	1
得到太阳，这就是我的祝愿	得|到|太|阳|，|这|就|是|我|的|祝|愿	0
如同花朵和青草，	如|同|花|朵|和|青|草|，	1
去吧，像羽毛一样飞过太平洋洋面	去|吧|，|像|羽|毛|一|样|飞|过|太|平|洋|洋|面	1
仿佛他身上射出金光一般。	仿|佛|他|身|上|射|出|金|光|一|般|。	1
恍若新婚的礼花抑或飘逸的红霞	恍|若|新|婚|的|礼|花|抑|或|飘|逸|的|红|霞	2
或光荣的秋天的瞬息的温存。	或|光|荣|的|秋|天|的|瞬|息|的|温|存|。	2
办公桌旋转起来，她成了上午的	办|公|桌|旋|转|起|来|，|她|成|了|上|午|的	2
仿佛要把蛛网编织，	仿|佛|要|把|蛛|网|编|织|，	1
仿佛瓷盘上	仿|佛|瓷|盘|上	1
穿过地铁检票口穿过三十二分钟	穿|过|地|铁|检|票|口|穿|过|三|十|二|分|钟	0
也不是伴随欢乐的哭泣而呼喊，	也|不|是|伴|随|欢|乐|的|哭|泣|而|呼|喊|，	2
身形刚刚，如秋叶落下	身|形|刚|刚|，|如|秋|叶|落|下	1
就象一个曾经的虚幻	就|象|一|个|曾|经|的|虚|幻	1
和什么杂耍场上的哄笑	和|什|么|杂|耍|场|上|的|哄|笑	0
我们学校真美丽，犹如一座梦幻般的城堡，多姿多彩。	我|们|学|校|真|美|丽|，|犹|如|一|座|梦|幻|般|的|城|堡|，|多|姿|多|彩|。	1
许多枫叶在我的脚下安睡	许|多|枫|叶|在|我|的|脚|下|安|睡	2
今日，太阳好害羞，躲在厚厚的云层后面，迟迟不肯露面。	今|日|，|太|阳|好|害|羞|，|躲|在|厚|厚|的|云|层|后|面|，|迟|迟|不|肯|露|面|。	2
仿佛在梦中听到一阵笑声；	仿|佛|在|梦|中|听|到|一|阵|笑|声|；	1
我那黄昏般的心灵之中娇艳的妇人	我|那|黄|昏|般|的|心|灵|之|中|娇|艳|的|妇|人	0
这无限展开的过程，仿佛一段蛇腰，	这|无|限|展|开|的|过|程|，|仿|佛|一|段|蛇|腰|，	1
而内心隐秘露出自豪而羞涩的本能，	而|内|心|隐|秘|露|出|自|豪|而|羞|涩|的|本|能|，	2
繁忙的天空消失了，孤独的大雾	繁|忙|的|天|空|消|失|了|，|孤|独|的|大|雾	0
她稳固如那个大窗。	她|稳|固|如|那|个|大|窗|。	1
河流经过村庄南侧	河|流|经|过|村|庄|南|侧	0
谁会心里充满悲伤？	谁|会|心|里|充|满|悲|伤|？	2
风暴，立刻被四川民工铸进缓缓上升的楼层。	风|暴|，|立|刻|被|四|川|民|工|铸|进|缓|缓|上|升|的|楼|层|。	0
仿佛在表示它们也许不太是狗。	仿|佛|在|表|示|它|们|也|许|不|太|是|狗|。	1
消失――你看见又好像没看见――��	消|失|―|―|你|看|见|又|好|像|没|看|见|―|―|�|�	1
当花朵般柔软地小手信任地抚摸	当|花|朵|般|柔|软|地|小|手|信|任|地|抚|摸	2
一种漫长的感觉不是开始所以也不是结束	一|种|漫|长|的|感|觉|不|是|开|始|所|以|也|不|是|结|束	0
冰凉的海底和岩石浮上来，	冰|凉|的|海|底|和|岩|石|浮|上|来|，	0
好像我们的心是用青铜铸成！	好|像|我|们|的|心|是|用|青|铜|铸|成|！	1
小红马驰过天庭，四个礼拜日，四个乘法	小|红|马|驰|过|天|庭|，|四|个|礼|拜|日|，|四|个|乘|法	0
就像慧星一样，他看见自己的	就|像|慧|星|一|样|，|他|看|见|自|己|的	1
波涛阵阵，秋风送爽	波|涛|阵|阵|，|秋|风|送|爽	0
耀眼的光盘使苍穹变成明亮蔚蓝的海洋。	耀|眼|的|光|盘|使|苍|穹|变|成|明|亮|蔚|蓝|的|海|洋|。	2
绕过行人和水果摊，我们看到树，看到云，	绕|过|行|人|和|水|果|摊|，|我|们|看|到|树|，|看|到|云|，	0
随着那只有天上才能唱出的优美旋律。	随|着|那|只|有|天|上|才|能|唱|出|的|优|美|旋|律|。	2
你就是一场突发的暴雨	你|就|是|一|场|突|发|的|暴|雨	0
如空白的荧屏，闪着刺目的雪花	如|空|白|的|荧|屏|，|闪|着|刺|目|的|雪|花	1
大地有着被狼吃掉最后一个孩子后的寂静	大|地|有|着|被|狼|吃|掉|最|后|一|个|孩|子|后|的|寂|静	0
就象烈日在天上白白地燃烧	就|象|烈|日|在|天|上|白|白|地|燃|烧	1
大地变成一个柔软的摇篮，	大|地|变|成|一|个|柔|软|的|摇|篮|，	2
你们都黑得象我的脸一样。	你|们|都|黑|得|象|我|的|脸|一|样|。	1
而在由血缘关系维系的家族里	而|在|由|血|缘|关|系|维|系|的|家|族|里	0
仿佛回到童年，那些没有配音	仿|佛|回|到|童|年|，|那|些|没|有|配|音	1
并不是无声	并|不|是|无|声	0
轻颤的柳条在她肩头垂泣，	轻|颤|的|柳|条|在|她|肩|头|垂|泣|，	2
犹如被他自身的影子所追赶。	犹|如|被|他|自|身|的|影|子|所|追|赶|。	1
仿佛是用翡翠制成，	仿|佛|是|用|翡|翠|制|成|，	1
在山谷里酿成透明的好酒；	在|山|谷|里|酿|成|透|明|的|好|酒|；	0
不像是有意潜逃。	不|像|是|有|意|潜|逃|。	1
月亮也在屈辱着她的臣民	月|亮|也|在|屈|辱|着|她|的|臣|民	2
灼痛了我的眼睛，仿佛一朵	灼|痛|了|我|的|眼|睛|，|仿|佛|一|朵	1
仿佛它有难言的哀伤，	仿|佛|它|有|难|言|的|哀|伤|，	1
所以，还要进行第二次分裂	所|以|，|还|要|进|行|第|二|次|分|裂	0
转动着，流浪的夜，挖掘着双眼。	转|动|着|，|流|浪|的|夜|，|挖|掘|着|双|眼|。	2
像普通的柳树	像|普|通|的|柳|树	1
仿佛海上漂浮的冰山	仿|佛|海|上|漂|浮|的|冰|山	1
在永恒的黑夜里飞翔。	在|永|恒|的|黑|夜|里|飞|翔|。	0
在溧阳生成	在|溧|阳|生|成	0
她切近地望着地板上被杀的求婚者仿佛看着	她|切|近|地|望|着|地|板|上|被|杀|的|求|婚|者|仿|佛|看|着	1
犹如今天我默默面对远去的一切	犹|如|今|天|我|默|默|面|对|远|去|的|一|切	1
好像一分一分地拚命追赶！	好|像|一|分|一|分|地|拚|命|追|赶|！	1
压在久已厌倦的呻吟的心上，	压|在|久|已|厌|倦|的|呻|吟|的|心|上|，	2
这是一个灵魂和一座星球的罗曼蒂克。	这|是|一|个|灵|魂|和|一|座|星|球|的|罗|曼|蒂|克|。	0
尽管这里的犯罪率跌到冰点以下，	尽|管|这|里|的|犯|罪|率|跌|到|冰|点|以|下|，	0
回头看看仍空无一物	回|头|看|看|仍|空|无|一|物	0
孤傲地盛开。冷漠地站立	孤|傲|地|盛|开|。|冷|漠|地|站|立	2
仿佛我们从未作过儿童。	仿|佛|我|们|从|未|作|过|儿|童|。	1
仿佛所有的树叶一起飞到天上	仿|佛|所|有|的|树|叶|一|起|飞|到|天|上	1
月光看谷穗努力地丰稔	月|光|看|谷|穗|努|力|地|丰|稔	0
蓝色的星星在远处打着寒战。”	蓝|色|的|星|星|在|远|处|打|着|寒|战|。|”	2
种子发芽呼吸的气息	种|子|发|芽|呼|吸|的|气|息	2
快抱紧你赤裸的身体，护卫这美好的风采	快|抱|紧|你|赤|裸|的|身|体|，|护|卫|这|美|好|的|风|采	2
就象海湾静听大海轻轻地把它拍击	就|象|海|湾|静|听|大|海|轻|轻|地|把|它|拍|击	1
所有多余的话，好像都砸进了墙里。	所|有|多|余|的|话|，|好|像|都|砸|进|了|墙|里|。	1
----峡谷宛如幻境，	-|-|-|-|峡|谷|宛|如|幻|境|，	1
以梦为上的敦煌――――那七月也会寒冷	以|梦|为|上|的|敦|煌|―|―|―|―|那|七|月|也|会|寒|冷	1
仿佛随着这灿烂的光轮的沉落，	仿|佛|随|着|这|灿|烂|的|光|轮|的|沉|落|，	1
昨夜它太小，小得犹如	昨|夜|它|太|小|，|小|得|犹|如	1
在皮肤底下　某个地方　走着	在|皮|肤|底|下|　|某|个|地|方|　|走|着	0
像一块块大石头，在砸向臭水塘。	像|一|块|块|大|石|头|，|在|砸|向|臭|水|塘|。	1
你的厨房里有没有	你|的|厨|房|里|有|没|有	0
也许这正是由于我平生多劫的缘故	也|许|这|正|是|由|于|我|平|生|多|劫|的|缘|故	0
世上只有我们存在，就象翱翔的飞鸟。	世|上|只|有|我|们|存|在|，|就|象|翱|翔|的|飞|鸟|。	1
柔软、灼热，近乎透明	柔|软|、|灼|热|，|近|乎|透|明	2
每日的绝妙食谱。在她的纤腰	每|日|的|绝|妙|食|谱|。|在|她|的|纤|腰	1
仿佛它要离开这沙洲，	仿|佛|它|要|离|开|这|沙|洲|，	1
柔丝像盛开的郁金香，套索散发着麝香，	柔|丝|像|盛|开|的|郁|金|香|，|套|索|散|发|着|麝|香|，	1
也没有什么欢乐的或可爱的能生出来，	也|没|有|什|么|欢|乐|的|或|可|爱|的|能|生|出|来|，	2
没有怀疑这个词汇	没|有|怀|疑|这|个|词|汇	0
你那么小	你|那|么|小	0
我们仿佛还留在	我|们|仿|佛|还|留|在	1
感觉星星离城里人那么近，近得眼晕	感|觉|星|星|离|城|里|人|那|么|近|，|近|得|眼|晕	0
“所以请把安全帽戴紧吧……”一只呢喃的燕子	“|所|以|请|把|安|全|帽|戴|紧|吧|…|…|”|一|只|呢|喃|的|燕|子	0
仿佛是寻求安慰：往昔，	仿|佛|是|寻|求|安|慰|：|往|昔|，	1
我的心柔和得像棉花	我|的|心|柔|和|得|像|棉|花	1
她被唤醒，那些诗句	她|被|唤|醒|，|那|些|诗|句	0
仿佛每位被人遗弃的女孩都能被那种	仿|佛|每|位|被|人|遗|弃|的|女|孩|都|能|被|那|种	1
良史们狼毫般精确的洞见加重了语气。	良|史|们|狼|毫|般|精|确|的|洞|见|加|重|了|语|气|。	0
啊，你呀，眉毛好似深黛的弓，发鬈弯弯似花冠；	啊|，|你|呀|，|眉|毛|好|似|深|黛|的|弓|，|发|鬈|弯|弯|似|花|冠|；	1
一些人头落下来，象无望的果实	一|些|人|头|落|下|来|，|象|无|望|的|果|实	1
方向盘，轻松地转向令人晕眩的	方|向|盘|，|轻|松|地|转|向|令|人|晕|眩|的	1
天色一亮，接着又更紧地敛拢，仿佛把天空	天|色|一|亮|，|接|着|又|更|紧|地|敛|拢|，|仿|佛|把|天|空	1
在自我中好似身处锅炉。	在|自|我|中|好|似|身|处|锅|炉|。	1
羽毛球，并在那里，度过了大约三十分钟。	羽|毛|球|，|并|在|那|里|，|度|过|了|大|约|三|十|分|钟|。	0
也像是在笑	也|像|是|在|笑	1
来破壳而出，来让自己不断枯槁的头发不断 伸长，	来|破|壳|而|出|，|来|让|自|己|不|断|枯|槁|的|头|发|不|断| |伸|长|，	0
仿佛是这个世纪歪斜的尸体，	仿|佛|是|这|个|世|纪|歪|斜|的|尸|体|，	1
而生命的本质	而|生|命|的|本|质	0
这慰藉对于朋友和敌人——就像树脂一样。	这|慰|藉|对|于|朋|友|和|敌|人|—|—|就|像|树|脂|一|样|。	1
在盛夏的寂静里把我们	在|盛|夏|的|寂|静|里|把|我|们	0
闪电般的镰刀嚓嚓响，	闪|电|般|的|镰|刀|嚓|嚓|响|，	1
它好似风和冰河的巨大结构。	它|好|似|风|和|冰|河|的|巨|大|结|构|。	1
在这世上，苦难够多了。	在|这|世|上|，|苦|难|够|多|了|。	2
我就要离开大淀头村庄	我|就|要|离|开|大|淀|头|村|庄	0
从此我忧喜无常，为你变得如此憔悴而玩劣。	从|此|我|忧|喜|无|常|，|为|你|变|得|如|此|憔|悴|而|玩|劣|。	0
一个流浪汉，仿佛喝醉了，冻毙在雪被上	一|个|流|浪|汉|，|仿|佛|喝|醉|了|，|冻|毙|在|雪|被|上	1
犹如冬日的平底锅里煮着的星星	犹|如|冬|日|的|平|底|锅|里|煮|着|的|星|星	1
温柔的信创造了出来。	温|柔|的|信|创|造|了|出|来|。	2
我好像看见一摊血	我|好|像|看|见|一|摊|血	1
[注]本诗是为祝贺卞之琳八十寿辰而做，	[|注|]|本|诗|是|为|祝|贺|卞|之|琳|八|十|寿|辰|而|做|，	0
仿佛扩大到了群星	仿|佛|扩|大|到|了|群|星	1
发毛的小雨。一，二，一共三个，沉默地收着毛线――	发|毛|的|小|雨|。|一|，|二|，|一|共|三|个|，|沉|默|地|收|着|毛|线|―|―	0
不让烈火燃烧大地和天空。	不|让|烈|火|燃|烧|大|地|和|天|空|。	2
却被一个听力不好的人　迎头撞倒	却|被|一|个|听|力|不|好|的|人|　|迎|头|撞|倒	0
仿佛一股琉璜绿火，	仿|佛|一|股|琉|璜|绿|火|，	1
啊！体现丝绸与翡翠的华贵之王	啊|！|体|现|丝|绸|与|翡|翠|的|华|贵|之|王	0
就像用无人能懂的语言	就|像|用|无|人|能|懂|的|语|言	1
用餐巾纸抹拭着嘴唇	用|餐|巾|纸|抹|拭|着|嘴|唇	0
散落一地的谎言躲躲闪闪	散|落|一|地|的|谎|言|躲|躲|闪|闪	0
仿佛孤立也可以对折，在树林里呆久了，	仿|佛|孤|立|也|可|以|对|折|，|在|树|林|里|呆|久|了|，	1
这就是普希金和我诞生的地方	这|就|是|普|希|金|和|我|诞|生|的|地|方	0
犹如一个瞬间——	犹|如|一|个|瞬|间|—|—	1
在歌唱着精神和感官的热狂。	在|歌|唱|着|精|神|和|感|官|的|热|狂|。	2
鹅鱼大张着嘴，笑得恍惚&nbsp;	鹅|鱼|大|张|着|嘴|，|笑|得|恍|惚|&|n|b|s|p|;	2
心中怀着美好希望；	心|中|怀|着|美|好|希|望|；	2
一朵花上的蕊蜜吻醒我的手臂。	一|朵|花|上|的|蕊|蜜|吻|醒|我|的|手|臂|。	2
当阳光在醇香的稻穗上光芒闪耀的时刻，我仿佛忆起我的灵魂无处不在的往昔，仿佛听	当|阳|光|在|醇|香|的|稻|穗|上|光|芒|闪|耀|的|时|刻|，|我|仿|佛|忆|起|我|的|灵|魂|无|处|不|在|的|往|昔|，|仿|佛|听	1
窜进了森林的喉管	窜|进|了|森|林|的|喉|管	2
那时你正缓缓转颈	那|时|你|正|缓|缓|转|颈	0
像周围的积雪半已消融、下沉。	像|周|围|的|积|雪|半|已|消|融|、|下|沉|。	1
我的孩子，去，去站在他们愤懑的心中，把你的和善的眼光落在它们上面，好像那	我|的|孩|子|，|去|，|去|站|在|他|们|愤|懑|的|心|中|，|把|你|的|和|善|的|眼|光|落|在|它|们|上|面|，|好|像|那	1
不换衣服，就跌跌撞撞闯进潇洒的酒吧和红灯区	不|换|衣|服|，|就|跌|跌|撞|撞|闯|进|潇|洒|的|酒|吧|和|红|灯|区	0
仿佛所有的翅膀	仿|佛|所|有|的|翅|膀	1
象闪电那般耀眼刺目！	象|闪|电|那|般|耀|眼|刺|目|！	1
火红的枫叶像火花一样纷纷地飘落下来。	火|红|的|枫|叶|像|火|花|一|样|纷|纷|地|飘|落|下|来|。	1
我接受你仿佛准备从聚会离去，	我|接|受|你|仿|佛|准|备|从|聚|会|离|去|，	1
初夏的阳光把游人赶到树荫下	初|夏|的|阳|光|把|游|人|赶|到|树|荫|下	0
像是要给来到崖上的人开辟一条路途；	像|是|要|给|来|到|崖|上|的|人|开|辟|一|条|路|途|；	1
忽然我留下的根系好像	忽|然|我|留|下|的|根|系|好|像	1
沉默是她的面具	沉|默|是|她|的|面|具	0
它真的开始柔软起来了	它|真|的|开|始|柔|软|起|来|了	2
秋天是枫一样迷人的颜色	秋|天|是|枫|一|样|迷|人|的|颜|色	0
花园，在白石池中呜咽的喷泉，	花|园|，|在|白|石|池|中|呜|咽|的|喷|泉|，	2
重重叠叠的山冈沉默不语。	重|重|叠|叠|的|山|冈|沉|默|不|语|。	2
有人探手篱墙悄然抽走一块铁模坯具。	有|人|探|手|篱|墙|悄|然|抽|走|一|块|铁|模|坯|具|。	0
又像火车跑了一夜早已经过站	又|像|火|车|跑|了|一|夜|早|已|经|过|站	1
在阳光里，象废墟边远方而来的	在|阳|光|里|，|象|废|墟|边|远|方|而|来|的	1
月光灿烂如缎的静谧，	月|光|灿|烂|如|缎|的|静|谧|，	1
看不到有智慧鸟欢歌的	看|不|到|有|智|慧|鸟|欢|歌|的	2
不是爱变得太快啊，是它根本就没出现过！	不|是|爱|变|得|太|快|啊|，|是|它|根|本|就|没|出|现|过|！	0
巨大的石块飞跃着象反跳的冰雹，	巨|大|的|石|块|飞|跃|着|象|反|跳|的|冰|雹|，	1
托起我们深深的足迹	托|起|我|们|深|深|的|足|迹	0
犹如三张黑白相底叠印的图片	犹|如|三|张|黑|白|相|底|叠|印|的|图|片	1
包括我的以往	包|括|我|的|以|往	0
遍地翻开金色的水毡。	遍|地|翻|开|金|色|的|水|毡|。	2
有说不清的言辞的味道――像是在	有|说|不|清|的|言|辞|的|味|道|―|―|像|是|在	1
象爱库尔吉斯坦的幽夜的芳香。	象|爱|库|尔|吉|斯|坦|的|幽|夜|的|芳|香|。	1
从一只毒死的牡蛎内就要敞开另一个天空	从|一|只|毒|死|的|牡|蛎|内|就|要|敞|开|另|一|个|天|空	0
开始啼鸣歌唱	开|始|啼|鸣|歌|唱	2
这个秋天馨香飘过山水村庄的上空	这|个|秋|天|馨|香|飘|过|山|水|村|庄|的|上|空	0
温存地播种，喜乐地刈获，仿佛你的爱者要来吃这产物。	温|存|地|播|种|，|喜|乐|地|刈|获|，|仿|佛|你|的|爱|者|要|来|吃|这|产|物|。	1
钢铁的骨骼构成现代的体躯，	钢|铁|的|骨|骼|构|成|现|代|的|体|躯|，	2
呆在屋里的人开始	呆|在|屋|里|的|人|开|始	0
象是未曾绽放的花蕾，小女孩始终未绽开慰藉的语言	象|是|未|曾|绽|放|的|花|蕾|，|小|女|孩|始|终|未|绽|开|慰|藉|的|语|言	1
印刷工人享受到同样的兴奋。	印|刷|工|人|享|受|到|同|样|的|兴|奋|。	2
如果我好似那蜜语甜言，	如|果|我|好|似|那|蜜|语|甜|言|，	1
他说：‘可爱的树儿，你硕果满枝头，	他|说|：|‘|可|爱|的|树|儿|，|你|硕|果|满|枝|头|，	2
仿佛悲痛，为了想像而来��	仿|佛|悲|痛|，|为|了|想|像|而|来|�|�	1
无形的手掌掠过无限的江山，	无|形|的|手|掌|掠|过|无|限|的|江|山|，	0
草莓在水中	草|莓|在|水|中	0
回忆着短暂的一生和漫长的遗憾	回|忆|着|短|暂|的|一|生|和|漫|长|的|遗|憾	0
我们的衣裙丰富、华丽	我|们|的|衣|裙|丰|富|、|华|丽	0
好像离弃与凋零尽皆不得已之事，	好|像|离|弃|与|凋|零|尽|皆|不|得|已|之|事|，	1
并没有进入它的圈套	并|没|有|进|入|它|的|圈|套	0
是给予优厚的希冀，还是颓丧的废弃	是|给|予|优|厚|的|希|冀|，|还|是|颓|丧|的|废|弃	0
无雨的空气沉闷、不安	无|雨|的|空|气|沉|闷|、|不|安	0
我仿佛听到惊恐而低沉的呻吟：	我|仿|佛|听|到|惊|恐|而|低|沉|的|呻|吟|：	1
霜花；他身上的白袍，好似一颗颗	霜|花|；|他|身|上|的|白|袍|，|好|似|一|颗|颗	1
风中仿佛传来遗骨碰击的声音；	风|中|仿|佛|传|来|遗|骨|碰|击|的|声|音|；	1
你的身体恰似一条小溪，	你|的|身|体|恰|似|一|条|小|溪|，	1
他的微笑是蜘蛛的叮咬	他|的|微|笑|是|蜘|蛛|的|叮|咬	1
你象火焰，你是寒光，	你|象|火|焰|，|你|是|寒|光|，	1
悬挂着，如蜜蜂的轰鸣，	悬|挂|着|，|如|蜜|蜂|的|轰|鸣|，	1
经历过春天萌芽的破土，	经|历|过|春|天|萌|芽|的|破|土|，	0
屋角黑暗的米缸	屋|角|黑|暗|的|米|缸	0
支撑大地的诗句	支|撑|大|地|的|诗|句	0
在引人怜悯的年纪上，我竟好像成了保护人；	在|引|人|怜|悯|的|年|纪|上|，|我|竟|好|像|成|了|保|护|人|；	1
起那张犊皮信纸；但信纸却在退缩，仿佛它被收信人的犹豫所伤害。	起|那|张|犊|皮|信|纸|；|但|信|纸|却|在|退|缩|，|仿|佛|它|被|收|信|人|的|犹|豫|所|伤|害|。	1
就像遭到遗弃的空气。	就|像|遭|到|遗|弃|的|空|气|。	1
仿佛寒冷的池沼：然而他还是	仿|佛|寒|冷|的|池|沼|：|然|而|他|还|是	1
当一首诗歌伸出它的伟人之手	当|一|首|诗|歌|伸|出|它|的|伟|人|之|手	0
好像一些猝然倒下的人。	好|像|一|些|猝|然|倒|下|的|人|。	1
喧响，膨胀。仿佛有人在远处掀动着床单��	喧|响|，|膨|胀|。|仿|佛|有|人|在|远|处|掀|动|着|床|单|�|�	1
我来到你妊娠着李花的故乡	我|来|到|你|妊|娠|着|李|花|的|故|乡	0
收音机天天说个不停，令邻居十分厌恶！	收|音|机|天|天|说|个|不|停|，|令|邻|居|十|分|厌|恶|！	2
胆怯的小鹿边玩边想，	胆|怯|的|小|鹿|边|玩|边|想|，	2
哽在喉头的乡音	哽|在|喉|头|的|乡|音	0
好像整个世界已融化在其间；	好|像|整|个|世|界|已|融|化|在|其|间|；	1
沉睡的绝望，唤醒了痛苦的思绪：	沉|睡|的|绝|望|，|唤|醒|了|痛|苦|的|思|绪|：	2
可是夜里他常常飞开去寻找庇护，在高处的大山怀抱中，如人类毛茸茸的胸脯	可|是|夜|里|他|常|常|飞|开|去|寻|找|庇|护|，|在|高|处|的|大|山|怀|抱|中|，|如|人|类|毛|茸|茸|的|胸|脯	2
还有妻子、女儿和情人，都是	还|有|妻|子|、|女|儿|和|情|人|，|都|是	0
也许我什么都没有做	也|许|我|什|么|都|没|有|做	0
在水中奄奄待毙。这是在想象的荒原	在|水|中|奄|奄|待|毙|。|这|是|在|想|象|的|荒|原	2
仿佛想说：“啊不，别那么匆忙。”	仿|佛|想|说|：|“|啊|不|，|别|那|么|匆|忙|。|”	1
腓迫南：正是这样，我的精神好像在梦里似的，全然被束缚住	腓|迫|南|：|正|是|这|样|，|我|的|精|神|好|像|在|梦|里|似|的|，|全|然|被|束|缚|住	1
仿佛绷紧的布帆之于气流的吹向	仿|佛|绷|紧|的|布|帆|之|于|气|流|的|吹|向	1
土地  春秋的见证	土|地| | |春|秋|的|见|证	0
那独一无二的花纹，那种痛苦，仿佛遭受刑讯。	那|独|一|无|二|的|花|纹|，|那|种|痛|苦|，|仿|佛|遭|受|刑|讯|。	1
贪婪地抚摸这毒恶的花朵，	贪|婪|地|抚|摸|这|毒|恶|的|花|朵|，	2
高远和辽阔像两片嘴唇	高|远|和|辽|阔|像|两|片|嘴|唇	1
总之，保持矿泉水的纯洁有多重要	总|之|，|保|持|矿|泉|水|的|纯|洁|有|多|重|要	0
柔和得像我皮肤的衣服	柔|和|得|像|我|皮|肤|的|衣|服	1
城里人象七眠子都已熟睡，	城|里|人|象|七|眠|子|都|已|熟|睡|，	1
可以鸟瞰，有更多空气，也有更多石头；	可|以|鸟|瞰|，|有|更|多|空|气|，|也|有|更|多|石|头|；	0
她才从她那温柔的情郎的怀抱中脱身；	她|才|从|她|那|温|柔|的|情|郎|的|怀|抱|中|脱|身|；	2
仿佛丛树与星群	仿|佛|丛|树|与|星|群	1
像衣服一样挂上门钉。	像|衣|服|一|样|挂|上|门|钉|。	1
落叶随着风高低起舞。	落|叶|随|着|风|高|低|起|舞|。	2
在一个垃圾桶似的角落，象发霉的果酱。	在|一|个|垃|圾|桶|似|的|角|落|，|象|发|霉|的|果|酱|。	0
因此，大海的闪光才被我看成	因|此|，|大|海|的|闪|光|才|被|我|看|成	0
像一个恶梦，无情的距离压在我身上。	像|一|个|恶|梦|，|无|情|的|距|离|压|在|我|身|上|。	1
迎着微风起舞翩翩。	迎|着|微|风|起|舞|翩|翩|。	2
而此时的身体却在压抑转移后完全泛空	而|此|时|的|身|体|却|在|压|抑|转|移|后|完|全|泛|空	0
我害怕黑鸟，	我|害|怕|黑|鸟|，	0
会怎样曼妙地撩拨空气的喉结	会|怎|样|曼|妙|地|撩|拨|空|气|的|喉|结	0
[Title] 仿佛目空一切，仿佛堆积冷漠	[|T|i|t|l|e|]| |仿|佛|目|空|一|切|，|仿|佛|堆|积|冷|漠	1
象一个行乞的人渣，孓然一身	象|一|个|行|乞|的|人|渣|，|孓|然|一|身	1
一只鸟儿尖叫	一|只|鸟|儿|尖|叫	2
在你的全能下温柔地成熟	在|你|的|全|能|下|温|柔|地|成|熟|	2
我只是一片不知情的陆地	我|只|是|一|片|不|知|情|的|陆|地	2
慢慢地隆起仿佛在思忖着涌出地面，	慢|慢|地|隆|起|仿|佛|在|思|忖|着|涌|出|地|面|，	1
到3米距离处，仿佛两块磁石毫不费力就突然地拥抱在一起，满怀庄	到|3|米|距|离|处|，|仿|佛|两|块|磁|石|毫|不|费|力|就|突|然|地|拥|抱|在|一|起|，|满|怀|庄	1
好像正午的阳光	好|像|正|午|的|阳|光	1
犹如永无终点的马车。	犹|如|永|无|终|点|的|马|车|。	1
多么把握不住你正穿越青色密林的眼神。	多|么|把|握|不|住|你|正|穿|越|青|色|密|林|的|眼|神|。	0
像利刃一样伤害我。	像|利|刃|一|样|伤|害|我|。	1
仿佛为它们饱饮河水而欢庆，	仿|佛|为|它|们|饱|饮|河|水|而|欢|庆|，	1
剩下翠绿的一件，少妇头戴柳帽	剩|下|翠|绿|的|一|件|，|少|妇|头|戴|柳|帽	0
在雪崩似的绵软的缎子背上，	在|雪|崩|似|的|绵|软|的|缎|子|背|上|，	1
所有的梧桐树，都面容苍白	所|有|的|梧|桐|树|，|都|面|容|苍|白	2
如地图一样你缓缓展开，	如|地|图|一|样|你|缓|缓|展|开|，	1
宛如在空中，不举步就平稳地滑行，	宛|如|在|空|中|，|不|举|步|就|平|稳|地|滑|行|，	1
就把我的话语，像是灰烬和火星	就|把|我|的|话|语|，|像|是|灰|烬|和|火|星	1
覆叶会抵挡	覆|叶|会|抵|挡	0
现在，我又到了我死在的医院，我躺过的病床上	现|在|，|我|又|到|了|我|死|在|的|医|院|，|我|躺|过|的|病|床|上	0
她的眼睛召唤。	她|的|眼|睛|召|唤|。	2
有一头像是火钳烫出的鬈发。	有|一|头|像|是|火|钳|烫|出|的|鬈|发|。	1
在那吻着落叶雨点的人的身上，	在|那|吻|着|落|叶|雨|点|的|人|的|身|上|，	2
唯独骨子里的诗人	唯|独|骨|子|里|的|诗|人	1
那把刀子　昨天还在的	那|把|刀|子|　|昨|天|还|在|的	0
摇曳升起？	摇|曳|升|起|？	2
一家烟铺像一朵玫瑰熏香了	一|家|烟|铺|像|一|朵|玫|瑰|熏|香|了	1
在我的脸上一开一合	在|我|的|脸|上|一|开|一|合	0
只看一个人的着作，结果是不在好的:你就得不到多方面的优点。必须如蜜蜂一样，采过许多花，这才能酿出蜜来，倘若叮在一处，所得就十分有限，枯燥了。	只|看|一|个|人|的|着|作|，|结|果|是|不|在|好|的|:|你|就|得|不|到|多|方|面|的|优|点|。|必|须|如|蜜|蜂|一|样|，|采|过|许|多|花|，|这|才|能|酿|出|蜜|来|，|倘|若|叮|在|一|处|，|所|得|就|十|分|有|限|，|枯|燥|了|。	2
只留下没有什么可想的恐惧在心头升起；	只|留|下|没|有|什|么|可|想|的|恐|惧|在|心|头|升|起|；	2
我听说过那些音乐，犹如	我|听|说|过|那|些|音|乐|，|犹|如	1
仿佛眼睛开了花	仿|佛|眼|睛|开|了|花	1
而我，你的爱人，好似死神，	而|我|，|你|的|爱|人|，|好|似|死|神|，	1
这份虚构出来的生命的完美	这|份|虚|构|出|来|的|生|命|的|完|美	2
如同被女人的手所触摸	如|同|被|女|人|的|手|所|触|摸	1
太阳烧红最后一只铜盘	太|阳|烧|红|最|后|一|只|铜|盘	0
风儿清唱著歌，唤醒了沉睡中的大地。	风|儿|清|唱|著|歌|，|唤|醒|了|沉|睡|中|的|大|地|。	2
它会不会变成一条橡皮鱼	它|会|不|会|变|成|一|条|橡|皮|鱼	2
约耳。”她说话好像不能转头一样。	约|耳|。|”|她|说|话|好|像|不|能|转|头|一|样|。	1
仿佛是一个来自他内心的声音。	仿|佛|是|一|个|来|自|他|内|心|的|声|音|。	1
犹如秋天的树叶随风飞扬，	犹|如|秋|天|的|树|叶|随|风|飞|扬|，	1
吹着沙，薄如烟，	吹|着|沙|，|薄|如|烟|，	1
让我带她到林中的小圆木屋，对她说：“我爱你，永生永世。”	让|我|带|她|到|林|中|的|小|圆|木|屋|，|对|她|说|：|“|我|爱|你|，|永|生|永|世|。|”	0
它的呼吸，促进冬天的温暖	它|的|呼|吸|，|促|进|冬|天|的|温|暖	0
满布哀痛的肉体，充满着恐惧，神秘，	满|布|哀|痛|的|肉|体|，|充|满|着|恐|惧|，|神|秘|，	2
一个渊博的大海  沉下思想中的星辰	一|个|渊|博|的|大|海| | |沉|下|思|想|中|的|星|辰	0
好像锯着自己的腿	好|像|锯|着|自|己|的|腿	1
可是那恶毒的海波泛滥而来，	可|是|那|恶|毒|的|海|波|泛|滥|而|来|，	2
他仿佛看到疼痛不断扩大的场面	他|仿|佛|看|到|疼|痛|不|断|扩|大|的|场|面	1
孤夜中，雪白的乳房唤醒沉睡的羊群	孤|夜|中|，|雪|白|的|乳|房|唤|醒|沉|睡|的|羊|群	2
这个八月就象女人	这|个|八|月|就|象|女|人	1
我梦到江南，走在同一条小巷	我|梦|到|江|南|，|走|在|同|一|条|小|巷	0
也神秘地不肯让人把面纱撕去，	也|神|秘|地|不|肯|让|人|把|面|纱|撕|去|，	2
旋转为一团燃烧的民族魂	旋|转|为|一|团|燃|烧|的|民|族|魂	2
１９９９年的电厂应该动荡无比	１|９|９|９|年|的|电|厂|应|该|动|荡|无|比	0
迎接它的走向	迎|接|它|的|走|向	0
像是在等着我融入，像是只有我融入	像|是|在|等|着|我|融|入|，|像|是|只|有|我|融|入	1
他与她独处	他|与|她|独|处	0
象条船，搭乘着我们的心愿	象|条|船|，|搭|乘|着|我|们|的|心|愿	1
摇晃套摇晃仿佛	摇|晃|套|摇|晃|仿|佛	1
从前你的深情拥抱过的山岗，	从|前|你|的|深|情|拥|抱|过|的|山|岗|，	0
[Title]大海以空洞的嗓音哭叫着，	[|T|i|t|l|e|]|大|海|以|空|洞|的|嗓|音|哭|叫|着|，	2
仿佛，人们也听到了可怖的嘶喊；	仿|佛|，|人|们|也|听|到|了|可|怖|的|嘶|喊|；	1
戴着藤帽的农民工	戴|着|藤|帽|的|农|民|工	0
上帝让你们讲不同的语言，	上|帝|让|你|们|讲|不|同|的|语|言|，	0
又听说，那电气像梦境一般美丽，掩映在天鹅绒般的熏烟里，	又|听|说|，|那|电|气|像|梦|境|一|般|美|丽|，|掩|映|在|天|鹅|绒|般|的|熏|烟|里|，	1
好似难闻的药水总是沉淀不动。	好|似|难|闻|的|药|水|总|是|沉|淀|不|动|。	1
Sam	S|a|m	0
直到下班回家，夜深之后	直|到|下|班|回|家|，|夜|深|之|后	0
前阶的青草仿佛在摇摆，	前|阶|的|青|草|仿|佛|在|摇|摆|，	1
我那隐藏着的红松树干般勃起的力量	我|那|隐|藏|着|的|红|松|树|干|般|勃|起|的|力|量	0
这是柜子	这|是|柜|子	0
我什么也不想说　我无话可说	我|什|么|也|不|想|说|　|我|无|话|可|说	0
那里的床又小又窄，好像给犯人睡的	那|里|的|床|又|小|又|窄|，|好|像|给|犯|人|睡|的	1
朝向光，像月亮照着我。	朝|向|光|，|像|月|亮|照|着|我|。	1
当她在坠落的晕眩中苏醒过来，	当|她|在|坠|落|的|晕|眩|中|苏|醒|过|来|，	2
然后，不发一言	然|后|，|不|发|一|言	0
好象去参加节日前的大扫除	好|象|去|参|加|节|日|前|的|大|扫|除	1
没有令上帝发笑的思考	没|有|令|上|帝|发|笑|的|思|考	0
每只往来的云雀都是我故知。	每|只|往|来|的|云|雀|都|是|我|故|知|。	2
仿佛失火时的浓烟滚滚一样，	仿|佛|失|火|时|的|浓|烟|滚|滚|一|样|，	1
老夕阳坐在覆满残雪的屋顶  似乎	老|夕|阳|坐|在|覆|满|残|雪|的|屋|顶| | |似|乎	2
黄昏来临，犹如十万只寒鸦，	黄|昏|来|临|，|犹|如|十|万|只|寒|鸦|，	1
万人都要从我刀口走过去建筑祖国	万|人|都|要|从|我|刀|口|走|过|去|建|筑|祖|国	0
就会把死亡幻变成慈母的怀抱，	就|会|把|死|亡|幻|变|成|慈|母|的|怀|抱|，	2
像快活的导游走在城里	像|快|活|的|导|游|走|在|城|里	1
鱼不会说话……人曾经断言。谁知道？	鱼|不|会|说|话|…|…|人|曾|经|断|言|。|谁|知|道|？	2
超级女生打扮成不会娱乐的	超|级|女|生|打|扮|成|不|会|娱|乐|的	2
犹如移向木头房子的今天	犹|如|移|向|木|头|房|子|的|今|天	1
我的眼睛——因思念你变得象玛瑙一样红，	我|的|眼|睛|—|—|因|思|念|你|变|得|象|玛|瑙|一|样|红|，	1
色泽柔和如苹果花一样。	色|泽|柔|和|如|苹|果|花|一|样|。	1
我看见了自己的灰烬	我|看|见|了|自|己|的|灰|烬	1
这是谁的狂欢之夜呵，生活的帷幕后盛宴酣畅	这|是|谁|的|狂|欢|之|夜|呵|，|生|活|的|帷|幕|后|盛|宴|酣|畅	0
如同谦卑的侍者，如同稍稍沙哑的钟声，	如|同|谦|卑|的|侍|者|，|如|同|稍|稍|沙|哑|的|钟|声|，	1
精力多么旺盛，	精|力|多|么|旺|盛|，	0
从那样的黑夜，那样的迷雾	从|那|样|的|黑|夜|，|那|样|的|迷|雾	0
她还没有端酒怀，就醉了。	她|还|没|有|端|酒|怀|，|就|醉|了|。	1
破碎而无用的文字	破|碎|而|无|用|的|文|字	0
在我们的国土上	在|我|们|的|国|土|上	1
我信任你像信任铁的品质	我|信|任|你|像|信|任|铁|的|品|质	1
它的坠落并没有象一块大玻璃那样四散开去	它|的|坠|落|并|没|有|象|一|块|大|玻|璃|那|样|四|散|开|去	1
所以我	所|以|我	0
“当一场10英寸厚的雪／象细碎的电石片中的	“|当|一|场|1|0|英|寸|厚|的|雪|／|象|细|碎|的|电|石|片|中|的	1
并非充满悲伤，只是希望确信	并|非|充|满|悲|伤|，|只|是|希|望|确|信	2
妃子倾听，美人鱼跃出－－	妃|子|倾|听|，|美|人|鱼|跃|出|－|－	0
总会有许多事物将被留下　像海面上	总|会|有|许|多|事|物|将|被|留|下|　|像|海|面|上	1
犹如一匹奔跑的马	犹|如|一|匹|奔|跑|的|马	1
芳香迎着敌意依然会上升	芳|香|迎|着|敌|意|依|然|会|上|升	0
上升。俾特丽采使赞歌持续	上|升|。|俾|特|丽|采|使|赞|歌|持|续	0
和奇怪的盘子柔和地燃烧，消耗它们自己	和|奇|怪|的|盘|子|柔|和|地|燃|烧|，|消|耗|它|们|自|己	2
我听得我的脚步如马刺振响，	我|听|得|我|的|脚|步|如|马|刺|振|响|，	1
我要象飞毛腿一样	我|要|象|飞|毛|腿|一|样	1
沉默的诗人，仿佛要	沉|默|的|诗|人|，|仿|佛|要	1
仿佛我还有一条命	仿|佛|我|还|有|一|条|命	1
像一处溃疡使我无法开口	像|一|处|溃|疡|使|我|无|法|开|口	1
军队里抽泣！老人们在公园里哭泣！	军|队|里|抽|泣|！|老|人|们|在|公|园|里|哭|泣|！	2
们卑鄙的恐惧中，就仿佛这孤独的世界是盲目	们|卑|鄙|的|恐|惧|中|，|就|仿|佛|这|孤|独|的|世|界|是|盲|目	1
光线迷了你的双眼呵，无人相信	光|线|迷|了|你|的|双|眼|呵|，|无|人|相|信	0
庭院清凉，穿过槐花的光线	庭|院|清|凉|，|穿|过|槐|花|的|光|线	1
可是某种东西通过瞬间的词句在唱，	可|是|某|种|东|西|通|过|瞬|间|的|词|句|在|唱|，	2
我在墨镜后站着想你	我|在|墨|镜|后|站|着|想|你	0
少年迈着浪漫憧憬的步伐	少|年|迈|着|浪|漫|憧|憬|的|步|伐	2
就像告别寿衣店出巷口	就|像|告|别|寿|衣|店|出|巷|口	1
渴望，是他们惟一留下的词	渴|望|，|是|他|们|惟|一|留|下|的|词	0
永远抵达必须受伤的距离	永|远|抵|达|必|须|受|伤|的|距|离	0
女人又在潇洒地洗浴	女|人|又|在|潇|洒|地|洗|浴	0
阴沉的脑袋，仿佛坚硬的燧石，	阴|沉|的|脑|袋|，|仿|佛|坚|硬|的|燧|石|，	1
留恋它象长长的记忆，拒绝我们象冰，	留|恋|它|象|长|长|的|记|忆|，|拒|绝|我|们|象|冰|，	1
就象皮箱	就|象|皮|箱	1
拉扯住过路人的衣裳，跟他们谈谈爱情谈谈生命也顺便谈谈死亡	拉|扯|住|过|路|人|的|衣|裳|，|跟|他|们|谈|谈|爱|情|谈|谈|生|命|也|顺|便|谈|谈|死|亡	0
太阳啊，你这不朽的哲人，	太|阳|啊|，|你|这|不|朽|的|哲|人|，	0
像是没有教给他怎样去表情。	像|是|没|有|教|给|他|怎|样|去|表|情|。	1
大风，像披着玄色的命运长袍	大|风|，|像|披|着|玄|色|的|命|运|长|袍	1
仿佛，在另一个时代，是有用的宝贝：	仿|佛|，|在|另|一|个|时|代|，|是|有|用|的|宝|贝|：	1
两个一样的梦想，	两|个|一|样|的|梦|想|，	0
打着赤脚奔跑	打|着|赤|脚|奔|跑	2
仿佛恳求给它配上诗韵。	仿|佛|恳|求|给|它|配|上|诗|韵|。	1
从神火中走出来吧，旋转当空，	从|神|火|中|走|出|来|吧|，|旋|转|当|空|，	2
在沙滩上掘起瞌睡的春天	在|沙|滩|上|掘|起|瞌|睡|的|春|天	2
我在你的眼中行走宛如在水上，	我|在|你|的|眼|中|行|走|宛|如|在|水|上|，	1
来自同一个梦中的火光	来|自|同|一|个|梦|中|的|火|光	0
在肉体中仿佛享有荣耀，	在|肉|体|中|仿|佛|享|有|荣|耀|，	1
黑夜就是裹尸布把你埋葬。	黑|夜|就|是|裹|尸|布|把|你|埋|葬|。	1
小姑娘的心灵像棉花一样纯洁。	小|姑|娘|的|心|灵|像|棉|花|一|样|纯|洁|。	1
同时又仿佛有什么形而上在上升	同|时|又|仿|佛|有|什|么|形|而|上|在|上|升	1
经过她的芳唇和发丝。花朵一样向下游而去	经|过|她|的|芳|唇|和|发|丝|。|花|朵|一|样|向|下|游|而|去	1
仿佛她有了特殊的装备，	仿|佛|她|有|了|特|殊|的|装|备|，	1
所有的梧桐树，都面容苍白	所|有|的|梧|桐|树|，|都|面|容|苍|白	2
眺望，看到它像一个黑球	眺|望|，|看|到|它|像|一|个|黑|球	2
有大理石的影子咬你的脖子	有|大|理|石|的|影|子|咬|你|的|脖|子	2
海魂在风波上徘徊	海|魂|在|风|波|上|徘|徊	0
1998.6	1|9|9|8|.|6	0
好似太阳光集中于一个焦点，	好|似|太|阳|光|集|中|于|一|个|焦|点|，	1
这不像是自然现象。	这|不|像|是|自|然|现|象|。	1
宇宙的一切都在变动	宇|宙|的|一|切|都|在|变|动	0
春天像刚落地的娃娃，从头到脚都是新的，它生长着。	春|天|像|刚|落|地|的|娃|娃|，|从|头|到|脚|都|是|新|的|，|它|生|长|着|。	1
时时都在用暗语交谈	时|时|都|在|用|暗|语|交|谈	0
你意念中不曾失落的珍藏	你|意|念|中|不|曾|失|落|的|珍|藏	0
一只手象心律不齐的鸟	一|只|手|象|心|律|不|齐|的|鸟	1
秋天到了，树上金红的果子露出了笑脸，她们正在向着我们点头微笑呢！	秋|天|到|了|，|树|上|金|红|的|果|子|露|出|了|笑|脸|，|她|们|正|在|向|着|我|们|点|头|微|笑|呢|！	2
我也去写深秋的诗	我|也|去|写|深|秋|的|诗	0
哭呵，它光秃秃的――鱼刺	哭|呵|，|它|光|秃|秃|的|―|―|鱼|刺	0
化为了良田。	化|为|了|良|田|。	0
距离你们合住的地方一定不选	距|离|你|们|合|住|的|地|方|一|定|不|选	0
像金丝银发披垂悬挂。	像|金|丝|银|发|披|垂|悬|挂|。	1
我们将象乘船似地穿过雾中去。	我|们|将|象|乘|船|似|地|穿|过|雾|中|去|。	1
一尾冰鱼像胎儿一样	一|尾|冰|鱼|像|胎|儿|一|样	1
就象每天升起的太阳，每天	就|象|每|天|升|起|的|太|阳|，|每|天	1
仿佛一生的奔波突然到了尽头	仿|佛|一|生|的|奔|波|突|然|到|了|尽|头	1
当它朝向它自己的时候	当|它|朝|向|它|自|己|的|时|候	0
我终于病倒。仿佛那场火还走在我身上	我|终|于|病|倒|。|仿|佛|那|场|火|还|走|在|我|身|上	1
要强夺生命的充满痛苦的渴望！	要|强|夺|生|命|的|充|满|痛|苦|的|渴|望|！	2
得来的恐惧  要弄明白	得|来|的|恐|惧| | |要|弄|明|白	0
升起的海水来自昨天的低潮	升|起|的|海|水|来|自|昨|天|的|低|潮	0
轻快地挥手犹如字母Ｘ。	轻|快|地|挥|手|犹|如|字|母|Ｘ|。	1
一条枯涸了一半的河	一|条|枯|涸|了|一|半|的|河	0
磨损的心，因你们，而仿佛一轮	磨|损|的|心|，|因|你|们|，|而|仿|佛|一|轮	1
我呢，我渴望着回返	我|呢|，|我|渴|望|着|回|返	0
我愿意是那空气	我|愿|意|是|那|空|气	1
三十五元一件的T恤，黑暗在外面，已经慢慢聚拢。	三|十|五|元|一|件|的|T|恤|，|黑|暗|在|外|面|，|已|经|慢|慢|聚|拢|。	0
我们好像感觉到──	我|们|好|像|感|觉|到|─|─	1
好似拍打悬崖的浪花，	好|似|拍|打|悬|崖|的|浪|花|，	1
“我虽丧命，送我的命	“|我|虽|丧|命|，|送|我|的|命	2
站立的墓碑象它主人的生前睡醒	站|立|的|墓|碑|象|它|主|人|的|生|前|睡|醒	1
异国情调的幸福。讨厌的月事	异|国|情|调|的|幸|福|。|讨|厌|的|月|事	1
仿佛天空借着一场雨	仿|佛|天|空|借|着|一|场|雨	1
――这仿佛在说，	―|―|这|仿|佛|在|说|，	1
而且你还是那芳香的月亮把面粉	而|且|你|还|是|那|芳|香|的|月|亮|把|面|粉	1
仿佛你躺在铁锈中：振响，靛蓝……	仿|佛|你|躺|在|铁|锈|中|：|振|响|，|靛|蓝|…|…	1
你的注视就不会多余	你|的|注|视|就|不|会|多|余	0
犹如一个人染上四日热，就要颤抖发作，	犹|如|一|个|人|染|上|四|日|热|，|就|要|颤|抖|发|作|，	1
如今它已空得落不下脚步	如|今|它|已|空|得|落|不|下|脚|步	0
寂寞的面庞依稀仿佛，停在梦中	寂|寞|的|面|庞|依|稀|仿|佛|，|停|在|梦|中	1
我好象被一阵风扼住	我|好|象|被|一|阵|风|扼|住	1
树叶阴着脸挂满树枝	树|叶|阴|着|脸|挂|满|树|枝	2
优雅的曲颈好似浮雕的花纹，	优|雅|的|曲|颈|好|似|浮|雕|的|花|纹|，	1
我已经为它加班三天	我|已|经|为|它|加|班|三|天	0
像是在困倦的梦里，呼吸微微。	像|是|在|困|倦|的|梦|里|，|呼|吸|微|微|。	1
我走上的归程，那命运的航路	我|走|上|的|归|程|，|那|命|运|的|航|路	0
对今天的遗产我理应作出绝对的选择	对|今|天|的|遗|产|我|理|应|作|出|绝|对|的|选|择	0
市场上面开始热闹起来，	市|场|上|面|开|始|热|闹|起|来|，	2
就像那片火已经烧到更远的地方	就|像|那|片|火|已|经|烧|到|更|远|的|地|方	1
戈多会将脚	戈|多|会|将|脚	0
能源无忧无虑地自焚	能|源|无|忧|无|虑|地|自|焚	0
春天是一个优美的舞蹈，让世界充满微笑。	春|天|是|一|个|优|美|的|舞|蹈|，|让|世|界|充|满|微|笑|。	1
他的翅膀多得象斑斓的花朵	他|的|翅|膀|多|得|象|斑|斓|的|花|朵	1
淡红色的番茄，一只只挂在人字棚架上，像一盏盏彩灯。	淡|红|色|的|番|茄|，|一|只|只|挂|在|人|字|棚|架|上|，|像|一|盏|盏|彩|灯|。	1
微笑，灯油没有辛酸地溅出来”。起初，船只都追逐它；但是，它像一	微|笑|，|灯|油|没|有|辛|酸|地|溅|出|来|”|。|起|初|，|船|只|都|追|逐|它|；|但|是|，|它|像|一	2
在艳丽的春天。另有七分淡雅	在|艳|丽|的|春|天|。|另|有|七|分|淡|雅	0
仿佛向上帝禀告：“除你之外，我别无他想”。	仿|佛|向|上|帝|禀|告|：|“|除|你|之|外|，|我|别|无|他|想|”|。	1
我的脚趾正好十个	我|的|脚|趾|正|好|十|个	0
犹如星星在眨着眼睛。	犹|如|星|星|在|眨|着|眼|睛|。	1
那粪便就像是从人们的厠所里流出来的。	那|粪|便|就|像|是|从|人|们|的|厠|所|里|流|出|来|的|。	1
水族里没有谁怀疑我奇怪的形态	水|族|里|没|有|谁|怀|疑|我|奇|怪|的|形|态	0
感到自己的器官，好像被汽车堵着。	感|到|自|己|的|器|官|，|好|像|被|汽|车|堵|着|。	1
金翅目仿佛偶像并不存在��	金|翅|目|仿|佛|偶|像|并|不|存|在|�|�	1
也没有欢欣；	也|没|有|欢|欣|；	0
我感到草在我心中生长	我|感|到|草|在|我|心|中|生|长	0
危险的悬崖像刀片一样	危|险|的|悬|崖|像|刀|片|一|样	1
像流体把自己倾出一般	像|流|体|把|自|己|倾|出|一|般	1
好似一个世纪的折磨都积迫于一瞬间	好|似|一|个|世|纪|的|折|磨|都|积|迫|于|一|瞬|间	1
像天外来的陨石砸下的	像|天|外|来|的|陨|石|砸|下|的	1
只有那辽远的一角依然完整，	只|有|那|辽|远|的|一|角|依|然|完|整|，	0
好像那在枝上轻颤的叶子，	好|像|那|在|枝|上|轻|颤|的|叶|子|，	1
宛如树根之不依靠谁的旨意	宛|如|树|根|之|不|依|靠|谁|的|旨|意	1
一种感觉．像是从看不见的地方	一|种|感|觉|．|像|是|从|看|不|见|的|地|方	1
我亲手写下的文字之中棉朵一样的天鹅	我|亲|手|写|下|的|文|字|之|中|棉|朵|一|样|的|天|鹅	1
纵然语言为人所共有，但多数人立身处世仿佛各有其到。	纵|然|语|言|为|人|所|共|有|，|但|多|数|人|立|身|处|世|仿|佛|各|有|其|到|。	1
铁筋铁骨的架在黄浦江头的外白渡桥，	铁|筋|铁|骨|的|架|在|黄|浦|江|头|的|外|白|渡|桥|，	0
它们像糖一样融化	它|们|像|糖|一|样|融|化	1
现在，我的面孔	现|在|，|我|的|面|孔	0
小帆，我站在黄昏的街边想你	小|帆|，|我|站|在|黄|昏|的|街|边|想|你	0
只剩下一幅宽大的翅膀	只|剩|下|一|幅|宽|大|的|翅|膀	1
我找到撕裂自己皮肤的暴烈脾气	我|找|到|撕|裂|自|己|皮|肤|的|暴|烈|脾|气	0
像一只受伤的母兽舔食伤口。	像|一|只|受|伤|的|母|兽|舔|食|伤|口|。	1
好像在海浪里航行。我看见你一个人走到海滩去	好|像|在|海|浪|里|航|行|。|我|看|见|你|一|个|人|走|到|海|滩|去	1
到那时,心志就好像患者之悲叹:它能使你暂时舒畅,	到|那|时|,|心|志|就|好|像|患|者|之|悲|叹|:|它|能|使|你|暂|时|舒|畅|,	1
我是地下的太阳，力图冲破土地	我|是|地|下|的|太|阳|，|力|图|冲|破|土|地	2
它会死去，象大海拍击海堤	它|会|死|去|，|象|大|海|拍|击|海|堤	1
男人的羞涩，仿佛高山	男|人|的|羞|涩|，|仿|佛|高|山	1
它就在大海旁边	它|就|在|大|海|旁|边	1
我知道的只是他在一个工人家里被捕去；	我|知|道|的|只|是|他|在|一|个|工|人|家|里|被|捕|去|；	0
你是绚丽的蝴蝶、	你|是|绚|丽|的|蝴|蝶|、	1
扔掉一张毫无用处的好莱坞二饼，自摸	扔|掉|一|张|毫|无|用|处|的|好|莱|坞|二|饼|，|自|摸	0
仿佛无所不能的那位，	仿|佛|无|所|不|能|的|那|位|，	1
犹如门外的故人，以及那些伤心事	犹|如|门|外|的|故|人|，|以|及|那|些|伤|心|事	1
仿佛浪子摇摆的脚步声	仿|佛|浪|子|摇|摆|的|脚|步|声	1
如果你好似悦乐的皇后，	如|果|你|好|似|悦|乐|的|皇|后|，	1
每一座教堂的尖顶，都将	每|一|座|教|堂|的|尖|顶|，|都|将	0
月亮，长发低垂的女子	月|亮|，|长|发|低|垂|的|女|子	0
被风  轻轻翻到  最后一页  他要	被|风| | |轻|轻|翻|到| | |最|后|一|页| | |他|要	0
另一个海的水流过它们好像流过一张网；	另|一|个|海|的|水|流|过|它|们|好|像|流|过|一|张|网|；	1
年岁和恐惧，像护士一般，照顾着她，	年|岁|和|恐|惧|，|像|护|士|一|般|，|照|顾|着|她|，	1
一径马蹄踏破深山的寂默，	一|径|马|蹄|踏|破|深|山|的|寂|默|，	0
他不愿意就此告别	他|不|愿|意|就|此|告|别	0
就像有色玻璃上的写生画。	就|像|有|色|玻|璃|上|的|写|生|画|。	1
更且，找不到所谓共和	更|且|，|找|不|到|所|谓|共|和	0
那些迷漫在天边的水，码头和船只	那|些|迷|漫|在|天|边|的|水|，|码|头|和|船|只	0
夏天就象希望一样	夏|天|就|象|希|望|一|样	1
今年是多雨的季节。	今|年|是|多|雨|的|季|节|。	0
刺猬的身体如同一个长满了钢针的小圆球。	刺|猬|的|身|体|如|同|一|个|长|满|了|钢|针|的|小|圆|球|。	1
这个春天百合盛开的小镇  而那些	这|个|春|天|百|合|盛|开|的|小|镇| | |而|那|些	0
狂风肆虐，把郁金香花瓣摧残。	狂|风|肆|虐|，|把|郁|金|香|花|瓣|摧|残|。	2
隐私。它把女人想象成一只豹子，	隐|私|。|它|把|女|人|想|象|成|一|只|豹|子|，	1
我的进攻并不那么坚决	我|的|进|攻|并|不|那|么|坚|决	0
危机宛如积雪休闲的火山	危|机|宛|如|积|雪|休|闲|的|火|山	1
爱情变的简单明净，象只玻璃杯	爱|情|变|的|简|单|明|净|，|象|只|玻|璃|杯	1
很久很久心里像感受了什么奇迹，	很|久|很|久|心|里|像|感|受|了|什|么|奇|迹|，	0
毫无标记的楼房大门	毫|无|标|记|的|楼|房|大|门	0
书是智慧的钥匙	书|是|智|慧|的|钥|匙	1
奋斗，她的原来朱红色的口唇，现在象是炉底的冷灰，她的口颤	奋|斗|，|她|的|原|来|朱|红|色|的|口|唇|，|现|在|象|是|炉|底|的|冷|灰|，|她|的|口|颤	1
如果爱情好似生命，我的亲人，	如|果|爱|情|好|似|生|命|，|我|的|亲|人|，	1
像卑微的，无声地蠕动的蚂蚁	像|卑|微|的|，|无|声|地|蠕|动|的|蚂|蚁	1
唯一的大地 空寂的像一座刚被弃置的	唯|一|的|大|地| |空|寂|的|像|一|座|刚|被|弃|置|的	1
我的天蝎座上是一只伏卧的天鹅	我|的|天|蝎|座|上|是|一|只|伏|卧|的|天|鹅	0
铁门的另一边，操场上有一群孩子乱叫乱喊。	铁|门|的|另|一|边|，|操|场|上|有|一|群|孩|子|乱|叫|乱|喊|。	0
葡萄成熟了，挂在枝头就像一个个乌溜溜的大眼睛。	葡|萄|成|熟|了|，|挂|在|枝|头|就|像|一|个|个|乌|溜|溜|的|大|眼|睛|。	2
让河流成为痛哭的少女。在太阳下	让|河|流|成|为|痛|哭|的|少|女|。|在|太|阳|下	0
我嗅闻着你犹如你是	我|嗅|闻|着|你|犹|如|你|是	1
古佛洞的尽头是低矮的棚屋	古|佛|洞|的|尽|头|是|低|矮|的|棚|屋	0
我一生都由你、你的同类组成犹如	我|一|生|都|由|你|、|你|的|同|类|组|成|犹|如	1
琴声的幽咽	琴|声|的|幽|咽	0
到今天我还能想起你	到|今|天|我|还|能|想|起|你	0
在口袋放着，贴心的位置	在|口|袋|放|着|，|贴|心|的|位|置	0
不像是有意潜逃。	不|像|是|有|意|潜|逃|。	1
紧紧依靠着你，	紧|紧|依|靠|着|你|，	0
犹如一堆马屎陷在泥泞的地里	犹|如|一|堆|马|屎|陷|在|泥|泞|的|地|里	1
向星空哭泣，渴望	向|星|空|哭|泣|，|渴|望	2
"从闻鸡台望出去，是研究核武器的地方，你	"|从|闻|鸡|台|望|出|去|，|是|研|究|核|武|器|的|地|方|，|你	0
那是你的起点	那|是|你|的|起|点	0
仿佛在玩一场无聊透顶的游戏	仿|佛|在|玩|一|场|无|聊|透|顶|的|游|戏	1
而那洞穴里，却充满着活泼的幻想，	而|那|洞|穴|里|，|却|充|满|着|活|泼|的|幻|想|，	2
我的孩子，我这一只歌将扬起它的乐声围绕你的身旁，好像那爱情的热恋的手臂一	我|的|孩|子|，|我|这|一|只|歌|将|扬|起|它|的|乐|声|围|绕|你|的|身|旁|，|好|像|那|爱|情|的|热|恋|的|手|臂|一	1
吮吸出来	吮|吸|出|来	2
看起来仿佛是雪花莲泛着白光……	看|起|来|仿|佛|是|雪|花|莲|泛|着|白|光|…|…	1
娶一个健康的女子	娶|一|个|健|康|的|女|子	0
仿佛埃多拉迪国	仿|佛|埃|多|拉|迪|国	1
她不知道，这一刻，她有多美啊	她|不|知|道|，|这|一|刻|，|她|有|多|美|啊	0
让家里的人站起来，迎接那主	让|家|里|的|人|站|起|来|，|迎|接|那|主	2
语言的欢乐：它们歌唱，它们变换队列，	语|言|的|欢|乐|：|它|们|歌|唱|，|它|们|变|换|队|列|，	2
巨浪伸出双臂把我猛地托起。	巨|浪|伸|出|双|臂|把|我|猛|地|托|起|。	2
春天是位魔法师,她融化了冰雪,让小草破土而出	春|天|是|位|魔|法|师|,|她|融|化|了|冰|雪|,|让|小|草|破|土|而|出	1
我的灵魂可以转世，但幸福犹如悬于弦上	我|的|灵|魂|可|以|转|世|，|但|幸|福|犹|如|悬|于|弦|上	1
仿佛在青苔中读着	仿|佛|在|青|苔|中|读|着	1
拖在地上的身影	拖|在|地|上|的|身|影	1
和遨游于海蓝的鱼群	和|遨|游|于|海|蓝|的|鱼|群	0
仿佛他别离一刻的招呼，	仿|佛|他|别|离|一|刻|的|招|呼|，	1
明天将以绿色的脚步来到：	明|天|将|以|绿|色|的|脚|步|来|到|：	2
犹如剑锋上的寒光。	犹|如|剑|锋|上|的|寒|光|。	1
再用羊毫与狼毫	再|用|羊|毫|与|狼|毫	0
痛苦立即变成享受	痛|苦|立|即|变|成|享|受	2
唤醒了心头温柔的情感，——	唤|醒|了|心|头|温|柔|的|情|感|，|—|—	2
象从羊圈里迷失的羔羊。	象|从|羊|圈|里|迷|失|的|羔|羊|。	1
常常留住了漫步中的我，	常|常|留|住|了|漫|步|中|的|我|，	2
它也将在垂死者的眼珠里发绿，	它|也|将|在|垂|死|者|的|眼|珠|里|发|绿|，	2
一会儿翅膀碰着波浪，一会儿箭一般地直冲云霄，它叫	一|会|儿|翅|膀|碰|着|波|浪|，|一|会|儿|箭|一|般|地|直|冲|云|霄|，|它|叫	1
你人生的舞台	你|人|生|的|舞|台	0
去看一位你的母亲	去|看|一|位|你|的|母|亲	0
仿佛是被粗野地推倒在地，	仿|佛|是|被|粗|野|地|推|倒|在|地|，	1
像是凝结的血块。红宝石颜色的	像|是|凝|结|的|血|块|。|红|宝|石|颜|色|的	1
象丑恶的东西的黑色五脏：	象|丑|恶|的|东|西|的|黑|色|五|脏|：	1
他无情地老下去  把看破的红尘吸进肺里	他|无|情|地|老|下|去| | |把|看|破|的|红|尘|吸|进|肺|里	0
昨夜它太小，小得犹如	昨|夜|它|太|小|，|小|得|犹|如	1
这是我的棚。我在慢慢生长	这|是|我|的|棚|。|我|在|慢|慢|生|长|	2
在家里，穿着法兰绒长袍，像一只熊在浮冰上，	在|家|里|，|穿|着|法|兰|绒|长|袍|，|像|一|只|熊|在|浮|冰|上|，	1
把人变成透明物体，	把|人|变|成|透|明|物|体|，	2
如同沙滩上海鸥的脚印。	如|同|沙|滩|上|海|鸥|的|脚|印|。	1
请为我而沉默	请|为|我|而|沉|默	0
迷蒙幻影，仿佛我置身雾中一般	迷|蒙|幻|影|，|仿|佛|我|置|身|雾|中|一|般	1
前来，而是仿佛明净的夜的奔驰，	前|来|，|而|是|仿|佛|明|净|的|夜|的|奔|驰|，	1
中提琴声，在这灵敏如猫头鹰耳朵的林间	中|提|琴|声|，|在|这|灵|敏|如|猫|头|鹰|耳|朵|的|林|间	1
像是凝结的血块。红宝石颜色的	像|是|凝|结|的|血|块|。|红|宝|石|颜|色|的	1
象一串串紫色的眼睛	象|一|串|串|紫|色|的|眼|睛	1
走过的谷地仿佛野驴空腹，荒无人烟，	走|过|的|谷|地|仿|佛|野|驴|空|腹|，|荒|无|人|烟|，	1
诗人眨一眨眼睛　大翅膀已将他的窗子掩住	诗|人|眨|一|眨|眼|睛|　|大|翅|膀|已|将|他|的|窗|子|掩|住	0
我的生命是轻盈的，像在傍晚时	我|的|生|命|是|轻|盈|的|，|像|在|傍|晚|时	1
就像一根被风刮弯的白草	就|像|一|根|被|风|刮|弯|的|白|草	1
公园的花真漂亮，像夏日的星空一般的灿烂夺目。	公|园|的|花|真|漂|亮|，|像|夏|日|的|星|空|一|般|的|灿|烂|夺|目|。	1
聪慧、健康的充满力量的人哟。	聪|慧|、|健|康|的|充|满|力|量|的|人|哟|。	2
把害怕死亡的裙子拧成了绳	把|害|怕|死|亡|的|裙|子|拧|成|了|绳	0
我开始闹解放	我|开|始|闹|解|放	0
就象那影儿一样悄然移动，	就|象|那|影|儿|一|样|悄|然|移|动|，	1
好似印第安人的头发。	好|似|印|第|安|人|的|头|发|。	1
仿佛我们从未作过儿童。	仿|佛|我|们|从|未|作|过|儿|童|。	1
你迷蒙的黑瞳，前方是倾斜再倾斜的阳光	你|迷|蒙|的|黑|瞳|，|前|方|是|倾|斜|再|倾|斜|的|阳|光	0
象一个个生动的诗歌的句子，在漫长的冬季里	象|一|个|个|生|动|的|诗|歌|的|句|子|，|在|漫|长|的|冬|季|里	1
它在梦中听见了	它|在|梦|中|听|见|了	0
眩晕中，一颗头颅探出来：	眩|晕|中|，|一|颗|头|颅|探|出|来|：	0
光线如同枯燥的水流落下	光|线|如|同|枯|燥|的|水|流|落|下	1
她那红润润的圆脸蛋，像溢满浆汁的苹果。	她|那|红|润|润|的|圆|脸|蛋|，|像|溢|满|浆|汁|的|苹|果|。	1
一个伤口里有挥霍不完的黑夜	一|个|伤|口|里|有|挥|霍|不|完|的|黑|夜	0
等待已久的树林，	等|待|已|久|的|树|林|，	0
话说出来也要有些分量；	话|说|出|来|也|要|有|些|分|量|；	0
草原碧绿而柔软，如同上好的绸缎，泛着光泽。	草|原|碧|绿|而|柔|软|，|如|同|上|好|的|绸|缎|，|泛|着|光|泽|。	1
早晨走近了	早|晨|走|近|了	0
他从古至今――-"日"――――他无比辉煌	他|从|古|至|今|―|―|-|"|日|"|―|―|―|―|他|无|比|辉|煌	0
充满了无限欢欣，	充|满|了|无|限|欢|欣|，	2
宛如月亮抛弃了群星把自己藏匿	宛|如|月|亮|抛|弃|了|群|星|把|自|己|藏|匿	1
悄悄低语的是阔叶树林――	悄|悄|低|语|的|是|阔|叶|树|林|―|―	2
下了山	下|了|山	0
一小片轻盈的月光。	一|小|片|轻|盈|的|月|光|。	1
或者，立即中断一个诗人漆黑的写作。	或|者|，|立|即|中|断|一|个|诗|人|漆|黑|的|写|作|。	0
仿佛冷冽的泉水触及	仿|佛|冷|冽|的|泉|水|触|及	1
以渴望涂抹着尚未升起的旭日。	以|渴|望|涂|抹|着|尚|未|升|起|的|旭|日|。	2
我听到蚌，在相爱时刻	我|听|到|蚌|，|在|相|爱|时|刻	0
当天下午，语言的尸体	当|天|下|午|，|语|言|的|尸|体	0
有时诗会摘下眼睛	有|时|诗|会|摘|下|眼|睛	0
好像月亮爬上天空，	好|像|月|亮|爬|上|天|空|，	1
像希望一样	像|希|望|一|样	1
我一见他就宛如太阳显现在我眼前。	我|一|见|他|就|宛|如|太|阳|显|现|在|我|眼|前|。	1
你象神秘而苍白的汗滴在这额上淋漓滚跃，	你|象|神|秘|而|苍|白|的|汗|滴|在|这|额|上|淋|漓|滚|跃|，	1
就象这雪后宁静的一夜∶	就|象|这|雪|后|宁|静|的|一|夜|∶	1
无论是喜悦或悲伤都会溜走：	无|论|是|喜|悦|或|悲|伤|都|会|溜|走|：	2
苍老的枫树支着一条腿，	苍|老|的|枫|树|支|着|一|条|腿|，	2
巨石抖动	巨|石|抖|动	2
再会，在再会的时间里再会……	再|会|，|在|再|会|的|时|间|里|再|会|…|…	0
是因为我看到	是|因|为|我|看|到	0
一会儿又顽皮放纵。	一|会|儿|又|顽|皮|放|纵|。	2
噜噜噜响的长线圈，露露，噜噜噜低唱的爱情关押在屋里。	噜|噜|噜|响|的|长|线|圈|，|露|露|，|噜|噜|噜|低|唱|的|爱|情|关|押|在|屋|里|。	2
是奶牛的母亲，	是|奶|牛|的|母|亲|，	1
窃带我们的私语去告诉芦苇。	窃|带|我|们|的|私|语|去|告|诉|芦|苇|。	0
像墙壁那样彼此站立	像|墙|壁|那|样|彼|此|站|立	1
你像春天的天空，亲爱的，	你|像|春|天|的|天|空|，|亲|爱|的|，	1
失恋的脑，王位与圣杯在森林中游荡	失|恋|的|脑|，|王|位|与|圣|杯|在|森|林|中|游|荡	0
宽阔的大湖像―只瓷盘。	宽|阔|的|大|湖|像|―|只|瓷|盘|。	1
从落日熔金的工地现场，	从|落|日|熔|金|的|工|地|现|场|，	0
几乎像是一对朋友，在依依不舍地各行其路。	几|乎|像|是|一|对|朋|友|，|在|依|依|不|舍|地|各|行|其|路|。	1
自我那么轻，像棉花里的一根丝绒	自|我|那|么|轻|，|像|棉|花|里|的|一|根|丝|绒	1
仿佛我们在水池边的一小时	仿|佛|我|们|在|水|池|边|的|一|小|时	1
蘸着生命的汁液犹如蘸酱；	蘸|着|生|命|的|汁|液|犹|如|蘸|酱|；	1
读到哪儿了	读|到|哪|儿|了	0
然而，仿佛有某种力量，从遥远的地方，	然|而|，|仿|佛|有|某|种|力|量|，|从|遥|远|的|地|方|，	1
姐姐，回忆是情感的寄托	姐|姐|，|回|忆|是|情|感|的|寄|托	0
哭泣！是在为世界难过！抠藕的人在最低的地方	哭|泣|！|是|在|为|世|界|难|过|！|抠|藕|的|人|在|最|低|的|地|方	2
嫩叶象初生儿一样	嫩|叶|象|初|生|儿|一|样	1
象一丛白色的月光，	象|一|丛|白|色|的|月|光|，	1
在肉体中好似埋入地窖。	在|肉|体|中|好|似|埋|入|地|窖|。	1
犹如不知从哪来的幽灵	犹|如|不|知|从|哪|来|的|幽|灵	1
仆人也许您只会背诵；可是请问您会不会看着字一个一个地念？	仆|人|也|许|您|只|会|背|诵|；|可|是|请|问|您|会|不|会|看|着|字|一|个|一|个|地|念|？	2
在苦难的边际出现，和苦难联欢	在|苦|难|的|边|际|出|现|，|和|苦|难|联|欢	1
这是个最简洁的夜	这|是|个|最|简|洁|的|夜	0
他抬起头来，好像认识我似的，说道：“我雇你不用什么东西。”	他|抬|起|头|来|，|好|像|认|识|我|似|的|，|说|道|：|“|我|雇|你|不|用|什|么|东|西|。|”	1
它是单纯，又是所有一切的完全：	它|是|单|纯|，|又|是|所|有|一|切|的|完|全|：	0
像烟上升，像水下降。黑暗迫近。	像|烟|上|升|，|像|水|下|降|。|黑|暗|迫|近|。	1
我嘴部顽固的石锁，圆石上泛着青光	我|嘴|部|顽|固|的|石|锁|，|圆|石|上|泛|着|青|光	0
造物主正跪着	造|物|主|正|跪|着	2
空气，透过马的鼻孔还给我们的空气	空|气|，|透|过|马|的|鼻|孔|还|给|我|们|的|空|气	0
仿佛他们的先生的方式	仿|佛|他|们|的|先|生|的|方|式	1
中间嬉戏--	中|间|嬉|戏|-|-	2
你的睡眠当它那光滑幽黑的波浪	你|的|睡|眠|当|它|那|光|滑|幽|黑|的|波|浪	1
浓雾阻塞着我就象奶油	浓|雾|阻|塞|着|我|就|象|奶|油	1
好像是只马蹄。	好|像|是|只|马|蹄|。	1
哪怕面对那讪笑大地的欢乐的星星！	哪|怕|面|对|那|讪|笑|大|地|的|欢|乐|的|星|星|！	2
他宛如揽镜自照，眺望着罗马。	他|宛|如|揽|镜|自|照|，|眺|望|着|罗|马|。	1
还要给后人留下一堆	还|要|给|后|人|留|下|一|堆	0
它以过去的永恒影响现在	它|以|过|去|的|永|恒|影|响|现|在	0
满脸麻子，像沙漠坑坑点点，	满|脸|麻|子|，|像|沙|漠|坑|坑|点|点|，	1
大鸟硕大如同海天之间包孕的珍珠	大|鸟|硕|大|如|同|海|天|之|间|包|孕|的|珍|珠	2
仿佛已经爱了千年	仿|佛|已|经|爱|了|千|年	1
它们从未拥抱。	它|们|从|未|拥|抱|。	2
好似点点灿烂的火尘。	好|似|点|点|灿|烂|的|火|尘|。	1
像游移的手，捂住我胸口迷人的中药	像|游|移|的|手|，|捂|住|我|胸|口|迷|人|的|中|药	1
这是个胆怯的夏天一颗仙桃被切开	这|是|个|胆|怯|的|夏|天|一|颗|仙|桃|被|切|开	0
是炉子倾斜太阳崩溃在山脊	是|炉|子|倾|斜|太|阳|崩|溃|在|山|脊	0
晃动，仿佛羽毛组成的巨大花朵，	晃|动|，|仿|佛|羽|毛|组|成|的|巨|大|花|朵|，	1
这一点它们不会知道；宛如被遗弃的傍晚的云朵，它们在无路可寻的黑暗中飘荡，	这|一|点|它|们|不|会|知|道|；|宛|如|被|遗|弃|的|傍|晚|的|云|朵|，|它|们|在|无|路|可|寻|的|黑|暗|中|飘|荡|，	1
踩着贵族的步伐	踩|着|贵|族|的|步|伐	0
就象悲剧中的年青主角，一身黑色衣裤	就|象|悲|剧|中|的|年|青|主|角|，|一|身|黑|色|衣|裤	1
像是千万人一起大病初愈。	像|是|千|万|人|一|起|大|病|初|愈|。	1
然后肯定会有人离去	然|后|肯|定|会|有|人|离|去	2
无边的孤单和沉寂	无|边|的|孤|单|和|沉|寂	0
仿佛就是上天的赐予，	仿|佛|就|是|上|天|的|赐|予|，	1
仿佛那蝙蝠	仿|佛|那|蝙|蝠	1
窗，好像发生了亚洲鼠疫。当城市的大部分区域正准备沉入夜生活的	窗|，|好|像|发|生|了|亚|洲|鼠|疫|。|当|城|市|的|大|部|分|区|域|正|准|备|沉|入|夜|生|活|的	1
刚刚诞生，不会终止，	刚|刚|诞|生|，|不|会|终|止|，	2
仿佛一切都不曾	仿|佛|一|切|都|不|曾	1
灵魂原来正是我自己，我们如此不可分开，	灵|魂|原|来|正|是|我|自|己|，|我|们|如|此|不|可|分|开|，	0
几只兔子从树枝匆匆跑过。	几|只|兔|子|从|树|枝|匆|匆|跑|过|。	0
如同盛开的水仙。像那些水仙花中的	如|同|盛|开|的|水|仙|。|像|那|些|水|仙|花|中|的	1
我甚至分辩不出	我|甚|至|分|辩|不|出	0
此刻正是平常的	此|刻|正|是|平|常|的	0
像在飘渺的梦中结束了一生，	像|在|飘|渺|的|梦|中|结|束|了|一|生|，	1
更声仿佛带来了夜的严肃，	更|声|仿|佛|带|来|了|夜|的|严|肃|，	1
仿佛烧成灰烬的情书	仿|佛|烧|成|灰|烬|的|情|书	1
好像那些时光，那些地方，	好|像|那|些|时|光|，|那|些|地|方|，	1
唯有心灵，象深渊，任由沉湎……	唯|有|心|灵|，|象|深|渊|，|任|由|沉|湎|…|…	1
兴奋变得平静，明亮的眼睛张不开；	兴|奋|变|得|平|静|，|明|亮|的|眼|睛|张|不|开|；	2
由远至近，由弱至强，像一个个风暴的中心	由|远|至|近|，|由|弱|至|强|，|像|一|个|个|风|暴|的|中|心	1
万人都要将火熄灭我一人独将此	万|人|都|要|将|火|熄|灭|我|一|人|独|将|此	0
我们象冰铸的十字一样永恒，	我|们|象|冰|铸|的|十|字|一|样|永|恒|，	1
如果你好似悦乐的皇后，	如|果|你|好|似|悦|乐|的|皇|后|，	1
字典就好像一个不开口的老师一样。	字|典|就|好|像|一|个|不|开|口|的|老|师|一|样|。	1
母亲是我的闹钟，天天准时把我唤醒。	母|亲|是|我|的|闹|钟|，|天|天|准|时|把|我|唤|醒|。	1
我们将象乘船似地穿过雾中去。	我|们|将|象|乘|船|似|地|穿|过|雾|中|去|。	1
霁虹小区仿佛迷宫	霁|虹|小|区|仿|佛|迷|宫	1
六百年后，女修用同样的方法制造了秦部。	六|百|年|后|，|女|修|用|同|样|的|方|法|制|造|了|秦|部|。	0
如一张纯而又纯的纸	如|一|张|纯|而|又|纯|的|纸	1
回到平原上唯一甜蜜的童年记忆。	回|到|平|原|上|唯|一|甜|蜜|的|童|年|记|忆|。	0
此刻我对你的爱犹如一头小象，	此|刻|我|对|你|的|爱|犹|如|一|头|小|象|，	1
它们是比祖母更柔和更衰老：	它|们|是|比|祖|母|更|柔|和|更|衰|老|：	2
路还可以看见	路|还|可|以|看|见	0
仿佛夜的全部数字。	仿|佛|夜|的|全|部|数|字|。	1
我总是忆起一些事情	我|总|是|忆|起|一|些|事|情	0
为了满足人的好奇	为|了|满|足|人|的|好|奇	0
10心儿呀不要沮丧天将破晓黎明即将来到。	1|0|心|儿|呀|不|要|沮|丧|天|将|破|晓|黎|明|即|将|来|到|。	2
象一只敬业的知了一样飞进我噩梦的边缘	象|一|只|敬|业|的|知|了|一|样|飞|进|我|噩|梦|的|边|缘	1
我们从南方回来的漂亮的旅客	我|们|从|南|方|回|来|的|漂|亮|的|旅|客	0
它好像什么也不是，更是个人形，	它|好|像|什|么|也|不|是|，|更|是|个|人|形|，	1
这儿的新草	这|儿|的|新|草	1
我爱你	我|爱|你	0
我的手仿佛两只狗，停在	我|的|手|仿|佛|两|只|狗|，|停|在	1
几次轻吻，几次拥抱，伸出两臂想搂住什么，	几|次|轻|吻|，|几|次|拥|抱|，|伸|出|两|臂|想|搂|住|什|么|，	2
如同狂风暴雨中带着雷电的云。	如|同|狂|风|暴|雨|中|带|着|雷|电|的|云|。	1
无数求爱的话，都已说过，但还没有赢得她的心；劝诱向她伸出渴望的臂，也是枉	无|数|求|爱|的|话|，|都|已|说|过|，|但|还|没|有|赢|得|她|的|心|；|劝|诱|向|她|伸|出|渴|望|的|臂|，|也|是|枉	2
仿佛为了走近她，我的目光把她寻找。	仿|佛|为|了|走|近|她|，|我|的|目|光|把|她|寻|找|。	1
对它的一切，我无能为力	对|它|的|一|切|，|我|无|能|为|力	0
看它在墙角扭动着身子，仿佛	看|它|在|墙|角|扭|动|着|身|子|，|仿|佛	1
犹如天堂的光明使者，她来了，�D�D	犹|如|天|堂|的|光|明|使|者|，|她|来|了|，|�|D|�|D	1
划过夜色，像一根颤抖的针。	划|过|夜|色|，|像|一|根|颤|抖|的|针|。	1
进入到空旷的夜晚，云，把一切	进|入|到|空|旷|的|夜|晚|，|云|，|把|一|切	0
小雨滴把荷叶当成了他的天然溜冰场，在上面欢快的挥洒自己的笑容。	小|雨|滴|把|荷|叶|当|成|了|他|的|天|然|溜|冰|场|，|在|上|面|欢|快|的|挥|洒|自|己|的|笑|容|。	2
“国王”端坐，仿佛肥胖的学究，	“|国|王|”|端|坐|，|仿|佛|肥|胖|的|学|究|，	1
他们像汗珠一样出来。他们蹲着，跳着，	他|们|像|汗|珠|一|样|出|来|。|他|们|蹲|着|，|跳|着|，	1
把你呛得跌下冷枕头。	把|你|呛|得|跌|下|冷|枕|头|。	1
以不平衡为标准	以|不|平|衡|为|标|准	0
拂动着路旁小草的铃铛。	拂|动|着|路|旁|小|草|的|铃|铛|。	2
你来到我这儿，带走我	你|来|到|我|这|儿|，|带|走|我	0
蝙蝠把寓意的天空隐藏在地下墓堂	蝙|蝠|把|寓|意|的|天|空|隐|藏|在|地|下|墓|堂	2
一颗悲哀的心，	一|颗|悲|哀|的|心|，	0
屋后我写过的那黑森林	屋|后|我|写|过|的|那|黑|森|林	0
犹如环佩之鸣锵锵。	犹|如|环|佩|之|鸣|锵|锵|。	1
画眉蛋像低小天穹，画眉的歌声	画|眉|蛋|像|低|小|天|穹|，|画|眉|的|歌|声	1
像淋湿的金币一样闪闪发光，坚贞的夹竹桃	像|淋|湿|的|金|币|一|样|闪|闪|发|光|，|坚|贞|的|夹|竹|桃	1
因为香篆不燃烧，就不会发出芬芳；灯火不点亮，也不会放射光芒。	因|为|香|篆|不|燃|烧|，|就|不|会|发|出|芬|芳|；|灯|火|不|点|亮|，|也|不|会|放|射|光|芒|。	2
一张挂满珍珠的犁	一|张|挂|满|珍|珠|的|犁	0
正在经历蜕变的痛苦：从小火中	正|在|经|历|蜕|变|的|痛|苦|：|从|小|火|中	2
好像一个避世者	好|像|一|个|避|世|者	1
你看这春天谢满一地，仿佛	你|看|这|春|天|谢|满|一|地|，|仿|佛	1
象爱库尔吉斯坦的幽夜的芳香。	象|爱|库|尔|吉|斯|坦|的|幽|夜|的|芳|香|。	1
美丽的河流含笑点头，	美|丽|的|河|流|含|笑|点|头|，	2
感悟出与己不符的现实	感|悟|出|与|己|不|符|的|现|实	0
这是海面上悬起的的一滴水　它的质量直指	这|是|海|面|上|悬|起|的|的|一|滴|水|　|它|的|质|量|直|指	0
有时世界仿佛豁然敞亮，	有|时|世|界|仿|佛|豁|然|敞|亮|，	1
春天般的希望将开始悸动；	春|天|般|的|希|望|将|开|始|悸|动|；	1
依旧静谧的岛	依|旧|静|谧|的|岛	0
当一个城市像一位作家那样	当|一|个|城|市|像|一|位|作|家|那|样	1
一生就是这样在火光中寻找灰烬。	一|生|就|是|这|样|在|火|光|中|寻|找|灰|烬|。	0
我愿是棵树，让闪电和霹雳	我|愿|是|棵|树|，|让|闪|电|和|霹|雳	1
伸开手，好像在施舍，	伸|开|手|，|好|像|在|施|舍|，	1
离开了运动，	离|开|了|运|动|，	0
把思念当作一首诗	把|思|念|当|作|一|首|诗	1
我扶不稳身体。我的身体摇晃得厉害	我|扶|不|稳|身|体|。|我|的|身|体|摇|晃|得|厉|害	0
月亮奄奄一息地耽于昏厥状态，	月|亮|奄|奄|一|息|地|耽|于|昏|厥|状|态|，	2
有如一阵清风吹送着一只鸟儿或一只手。	有|如|一|阵|清|风|吹|送|着|一|只|鸟|儿|或|一|只|手|。	1
仿佛是这个世纪歪斜的尸体，	仿|佛|是|这|个|世|纪|歪|斜|的|尸|体|，	1
伸出漫不经心的手轻轻地抚摸，	伸|出|漫|不|经|心|的|手|轻|轻|地|抚|摸|，	2
昏暗的像手臂飞舞，	昏|暗|的|像|手|臂|飞|舞|，	2
母亲不让河流哭泣	母|亲|不|让|河|流|哭|泣	2
艺术应当像那面镜子	艺|术|应|当|像|那|面|镜|子	1
我也愿将牢底坐穿	我|也|愿|将|牢|底|坐|穿	0
谁会心里充满悲伤？	谁|会|心|里|充|满|悲|伤|？	2
如变态的虫蝶或蛇的幸福	如|变|态|的|虫|蝶|或|蛇|的|幸|福	0
宛如父亲、儿子和快活的母亲，	宛|如|父|亲|、|儿|子|和|快|活|的|母|亲|，	1
野外的景致----天空，山水，	野|外|的|景|致|-|-|-|-|天|空|，|山|水|，	2
大概是对苍天的容貌厌烦了，	大|概|是|对|苍|天|的|容|貌|厌|烦|了|，	2
我的心脏就像刀绞一样。	我|的|心|脏|就|像|刀|绞|一|样|。	1
在肉体中仿佛在监禁中，	在|肉|体|中|仿|佛|在|监|禁|中|，	1
危险的红灯，大白天拉上窗帘	危|险|的|红|灯|，|大|白|天|拉|上|窗|帘	0
桥依然如床。无人行走	桥|依|然|如|床|。|无|人|行|走	1
欣慰得像顾城或海子们	欣|慰|得|像|顾|城|或|海|子|们	1
啊，原谅我欲以爱心将你裹挟了：是这样的暴	啊|，|原|谅|我|欲|以|爱|心|将|你|裹|挟|了|：|是|这|样|的|暴	0
一还记得我吗　早遥远的法兰西	一|还|记|得|我|吗|　|早|遥|远|的|法|兰|西	0
这片土地哟，过去犹如被放逐的黎民！	这|片|土|地|哟|，|过|去|犹|如|被|放|逐|的|黎|民|！	1
你仿佛和我一样，身上有	你|仿|佛|和|我|一|样|，|身|上|有	1
植物洒满丝绒似的光华，	植|物|洒|满|丝|绒|似|的|光|华|，	1
仿佛来自天空的悲泣的云团，	仿|佛|来|自|天|空|的|悲|泣|的|云|团|，	1
它像太阳一样鼓舞我的心，	它|像|太|阳|一|样|鼓|舞|我|的|心|，	1
他们不会像卷曲的风儿一样死去；	他|们|不|会|像|卷|曲|的|风|儿|一|样|死|去|；	1
用鞭打制止的；可怜的女犯在流产，	用|鞭|打|制|止|的|；|可|怜|的|女|犯|在|流|产|，	2
犹如火镰打上火石，痛苦也倍加增长。	犹|如|火|镰|打|上|火|石|，|痛|苦|也|倍|加|增|长|。	1
翻越过多少大海和崎岖！	翻|越|过|多|少|大|海|和|崎|岖|！	0
走进沉睡的午夜	走|进|沉|睡|的|午|夜	0
杯子空了，就是空虚来临	杯|子|空|了|，|就|是|空|虚|来|临	0
一切都像是镜子，对照的	一|切|都|像|是|镜|子|，|对|照|的	1
仿佛怠懒就是他的同胞姐妹”。	仿|佛|怠|懒|就|是|他|的|同|胞|姐|妹|”|。	1
蟑螂箭般地箭般地窜向墙角，在墙上��	蟑|螂|箭|般|地|箭|般|地|窜|向|墙|角|，|在|墙|上|�|�	1
它们的歌都哭丧似的吓人，	它|们|的|歌|都|哭|丧|似|的|吓|人|，	2
红色的云缠在头上	红|色|的|云|缠|在|头|上	0
把这本书装饰得可爱优美	把|这|本|书|装|饰|得|可|爱|优|美	2
这时则是心猿意马，仿佛变得辽阔无涯，	这|时|则|是|心|猿|意|马|，|仿|佛|变|得|辽|阔|无|涯|，	1
像茎杆和钢铁一样生存……	像|茎|杆|和|钢|铁|一|样|生|存|…|…	1
他的头发也是白的，好似一条条	他|的|头|发|也|是|白|的|，|好|似|一|条|条	1
象一个守营的老兵。	象|一|个|守|营|的|老|兵|。	1
狂风暴雨像是那因他的爱情被大地所拒绝而在痛苦中的天神的哭	狂|风|暴|雨|像|是|那|因|他|的|爱|情|被|大|地|所|拒|绝|而|在|痛|苦|中|的|天|神|的|哭	1
它静等一个姓名，似仙人掌渴望霖雨。	它|静|等|一|个|姓|名|，|似|仙|人|掌|渴|望|霖|雨|。	1
象龙涎香一样，	象|龙|涎|香|一|样|，	1
嬉戏的风儿对我说：	嬉|戏|的|风|儿|对|我|说|：	2
犹如从每根枝条之上，	犹|如|从|每|根|枝|条|之|上|，	1
仿佛由于疏忽而向他们显现	仿|佛|由|于|疏|忽|而|向|他|们|显|现	1
与夕阳打招呼，久久地眺望远方，	与|夕|阳|打|招|呼|，|久|久|地|眺|望|远|方|，	0
连希望都被窒息	连|希|望|都|被|窒|息	0
要速度更快，象海水升潮”	要|速|度|更|快|，|象|海|水|升|潮|”	1
我左手拎着塑料袋：明珠超市	我|左|手|拎|着|塑|料|袋|：|明|珠|超|市	0
另一个孪生兄弟	另|一|个|孪|生|兄|弟	0
水上的那块扁平小木板闷热难耐，	水|上|的|那|块|扁|平|小|木|板|闷|热|难|耐|，	2
公园里的花在微风的吹拂下翩翩起舞，真美啊。	公|园|里|的|花|在|微|风|的|吹|拂|下|翩|翩|起|舞|，|真|美|啊|。	1
秋天是打字机，来回移动，咔哒的响	秋|天|是|打|字|机|，|来|回|移|动|，|咔|哒|的|响	1
你在乎秋天里的每一次月圆	你|在|乎|秋|天|里|的|每|一|次|月|圆	0
就象延伸着漫长的思绪	就|象|延|伸|着|漫|长|的|思|绪	1
像消逝的流星陨落天边。	像|消|逝|的|流|星|陨|落|天|边|。	1
离愁好似鬼索命。	离|愁|好|似|鬼|索|命|。	1
红樱桃	红|樱|桃	0
过了春又到了夏，我在暗暗地憔悴，	过|了|春|又|到|了|夏|，|我|在|暗|暗|地|憔|悴|，	0
起舞的身影  他们注定要在这片土地上	起|舞|的|身|影| | |他|们|注|定|要|在|这|片|土|地|上	0
犹如湖水清澈的安宁。	犹|如|湖|水|清|澈|的|安|宁|。	1
你愉快的声音就象梦幻，	你|愉|快|的|声|音|就|象|梦|幻|，	1
提着沉甸甸的箱子像是拿着气球。	提|着|沉|甸|甸|的|箱|子|像|是|拿|着|气|球|。	1
像是死了，却不给人以死的恐怖。	像|是|死|了|，|却|不|给|人|以|死|的|恐|怖|。	1
仿佛我在一本书中找到的	仿|佛|我|在|一|本|书|中|找|到|的	1
为她安排的竟是深渊	为|她|安|排|的|竟|是|深|渊	0
好象进入睡梦之中，	好|象|进|入|睡|梦|之|中|，	1
梦着梦，迎接自己的诞生在每一个	梦|着|梦|，|迎|接|自|己|的|诞|生|在|每|一|个	2
你这颗有着成熟的香味的红色果实	你|这|颗|有|着|成|熟|的|香|味|的|红|色|果|实	0
大海以空洞的嗓音哭叫着，	大|海|以|空|洞|的|嗓|音|哭|叫|着|，	2
搂着她瘦削的肩膀	搂|着|她|瘦|削|的|肩|膀	0
就好像树叶	就|好|像|树|叶	1
唱一只老虎将安放在镜子里的手拉出来	唱|一|只|老|虎|将|安|放|在|镜|子|里|的|手|拉|出|来	2
一生就是这样在迁徙漂泊中饱尝悲哀。	一|生|就|是|这|样|在|迁|徙|漂|泊|中|饱|尝|悲|哀|。	0
喷泉静止，火焰正	喷|泉|静|止|，|火|焰|正	0
只有风在杀掠	只|有|风|在|杀|掠	2
我的心宛如一只叼着猎物的苍鹰，	我|的|心|宛|如|一|只|叼|着|猎|物|的|苍|鹰|，	1
心像身躯一样污浊、孱弱，波澜四起	心|像|身|躯|一|样|污|浊|、|孱|弱|，|波|澜|四|起	1
灯光保持两张软沙发的距离	灯|光|保|持|两|张|软|沙|发|的|距|离	0
我记起了孔雀的叫喊。	我|记|起|了|孔|雀|的|叫|喊|。	2
恋爱就象电脑，永远都有N个毛病等待修理，等你修好后却发现等待修理的新毛病大于N。	恋|爱|就|象|电|脑|，|永|远|都|有|N|个|毛|病|等|待|修|理|，|等|你|修|好|后|却|发|现|等|待|修|理|的|新|毛|病|大|于|N|。	1
它的形状滚圆，宛如花环，	它|的|形|状|滚|圆|，|宛|如|花|环|，	1
闪烁时分蒙上新面纱的心爱的人的脸庞。因此，在他眼中，蓝天像是为无数的聚散离合	闪|烁|时|分|蒙|上|新|面|纱|的|心|爱|的|人|的|脸|庞|。|因|此|，|在|他|眼|中|，|蓝|天|像|是|为|无|数|的|聚|散|离|合	1
好像磨沙玻璃	好|像|磨|沙|玻|璃	1
一地清纯的湖光山色，宛若吴越儿女。	一|地|清|纯|的|湖|光|山|色|，|宛|若|吴|越|儿|女|。	1
许多事情之发生,都像是在谴责我,	许|多|事|情|之|发|生|,|都|像|是|在|谴|责|我|,	1
夜风像喘奔的饿狼朝着她猛扑猛撞，	夜|风|像|喘|奔|的|饿|狼|朝|着|她|猛|扑|猛|撞|，	1
或VCD中才能看到。然后是《第一滴��	或|V|C|D|中|才|能|看|到|。|然|后|是|《|第|一|滴|�|�	2
枪声响起一如镜子，照出白鹅跌落芦苇	枪|声|响|起|一|如|镜|子|，|照|出|白|鹅|跌|落|芦|苇	1
一对恋人从狂热的拥抱中挣脱	一|对|恋|人|从|狂|热|的|拥|抱|中|挣|脱	2
正看着她离去	正|看|着|她|离|去	2
好像从此再也见不到他了。为了	好|像|从|此|再|也|见|不|到|他|了|。|为|了	1
照耀蓝色的马匹和梦想。	照|耀|蓝|色|的|马|匹|和|梦|想|。	0
就象刺猬的硬毛，	就|象|刺|猬|的|硬|毛|，	1
自然就是罗马，仿佛，再一次地，	自|然|就|是|罗|马|，|仿|佛|，|再|一|次|地|，	1
也许会比我的舌头更加美味	也|许|会|比|我|的|舌|头|更|加|美|味	0
生活如一股清泉，虽然无色无味，但是平淡而真实。	生|活|如|一|股|清|泉|，|虽|然|无|色|无|味|，|但|是|平|淡|而|真|实|。	1
用一个工具挖掘一生的问题；	用|一|个|工|具|挖|掘|一|生|的|问|题|；	0
我整日沉湎于幻想	我|整|日|沉|湎|于|幻|想	0
我看她像棵摇曳的得意棕榈树――	我|看|她|像|棵|摇|曳|的|得|意|棕|榈|树|―|―	1
犹如雪飘在湖上被水溶化	犹|如|雪|飘|在|湖|上|被|水|溶|化	0
犹如重物沉入深暗的水底。	犹|如|重|物|沉|入|深|暗|的|水|底|。	1
贪婪地吮吸着倦怠的晚汐	贪|婪|地|吮|吸|着|倦|怠|的|晚|汐	2
荷锄而立，又没闲着偷看?	荷|锄|而|立|，|又|没|闲|着|偷|看|?	0
梅花三两枝，仿佛吐血	梅|花|三|两|枝|，|仿|佛|吐|血	1
像入宫三次的人	像|入|宫|三|次|的|人	1
天空又悲又美，像大祭台一样。	天|空|又|悲|又|美|，|像|大|祭|台|一|样|。	1
你象藤枝偎依在我怀里，	你|象|藤|枝|偎|依|在|我|怀|里|，	1
就象掠过池水的风影，	就|象|掠|过|池|水|的|风|影|，	1
在山中和海上风景如画他和她以及它们	在|山|中|和|海|上|风|景|如|画|他|和|她|以|及|它|们	0
仿佛姑娘的嘴唇，嚼着熟莓子。	仿|佛|姑|娘|的|嘴|唇|，|嚼|着|熟|莓|子|。	1
躺在天堂身边，如占星家一般，	躺|在|天|堂|身|边|，|如|占|星|家|一|般|，	1
喜欢一个人静悄悄坐在店堂里	喜|欢|一|个|人|静|悄|悄|坐|在|店|堂|里	2
仿佛在计算它们的数目。	仿|佛|在|计|算|它|们|的|数|目|。	1
有了食物、冲动、合理化的补偿	有|了|食|物|、|冲|动|、|合|理|化|的|补|偿	0
我愿在草上悲伤地打着哈欠，面对黑暗的死……	我|愿|在|草|上|悲|伤|地|打|着|哈|欠|，|面|对|黑|暗|的|死|…|…	2
看见你的光辉就高兴；	看|见|你|的|光|辉|就|高|兴|；	0
可以到失物招领处找得回来，	可|以|到|失|物|招|领|处|找|得|回|来|，	0
小站的四周  挤满安静的小贩	小|站|的|四|周| | |挤|满|安|静|的|小|贩	1
天空的微风	天|空|的|微|风	2
生命宛如点燃的香烟，燃完就终结了。	生|命|宛|如|点|燃|的|香|烟|，|燃|完|就|终|结|了|。	1
哆嗦着，犹如忍受着痛疾，	哆|嗦|着|，|犹|如|忍|受|着|痛|疾|，	2
的汁液	的|汁|液	0
像是白色的鸽子；	像|是|白|色|的|鸽|子|；	1
已经变黑我无法像飞鸟一样深刻起来	已|经|变|黑|我|无|法|像|飞|鸟|一|样|深|刻|起|来	1
鸟儿在露水珠中入睡了，一片岑寂，	鸟|儿|在|露|水|珠|中|入|睡|了|，|一|片|岑|寂|，	2
然后像箭一样射过	然|后|像|箭|一|样|射|过	1
他们的舞姿象空气	他|们|的|舞|姿|象|空|气	1
宛若木偶一般；略微有些滑稽；	宛|若|木|偶|一|般|；|略|微|有|些|滑|稽|；	1
就像镜子迎接那张光茫四射的脸。	就|像|镜|子|迎|接|那|张|光|茫|四|射|的|脸|。	1
那是双鹰的嬉戏，	那|是|双|鹰|的|嬉|戏|，	2
一群人踩过遍地紫色幼花	一|群|人|踩|过|遍|地|紫|色|幼|花	0
古墙蜿蜒出刚强的手臂，	古|墙|蜿|蜒|出|刚|强|的|手|臂|，	2
田野上美丽的帐篷象花朵	田|野|上|美|丽|的|帐|篷|象|花|朵	1
她那极其柔软的身段，	她|那|极|其|柔|软|的|身|段|，	2
宛如反映出我的绝望的无边的明镜！	宛|如|反|映|出|我|的|绝|望|的|无|边|的|明|镜|！	1
仿佛还是炽热的，就象海	仿|佛|还|是|炽|热|的|，|就|象|海	1
在放倒的木材上锯着	在|放|倒|的|木|材|上|锯|着	0
温暖呵，依旧是温暖	温|暖|呵|，|依|旧|是|温|暖	0
爸爸，只有你知道，我希望的不过一场 灾难	爸|爸|，|只|有|你|知|道|，|我|希|望|的|不|过|一|场| |灾|难	0
懒洋洋地拂过湿润的草地，	懒|洋|洋|地|拂|过|湿|润|的|草|地|，	2
一团团滚动的乌云，在欢快地飞向某个地方……。周围	一|团|团|滚|动|的|乌|云|，|在|欢|快|地|飞|向|某|个|地|方|…|…|。|周|围	2
黑暗从灌木林中向外窥视，	黑|暗|从|灌|木|林|中|向|外|窥|视|，	2
就象云里飞；	就|象|云|里|飞|；	1
孩子灿烂的笑，山野清醇的风	孩|子|灿|烂|的|笑|，|山|野|清|醇|的|风	0
而河流犹如一道门和一把钥匙	而|河|流|犹|如|一|道|门|和|一|把|钥|匙	1
我的不成熟的艺术像炉火	我|的|不|成|熟|的|艺|术|像|炉|火	1
当你飞翔的臀部穿过苹果树影	当|你|飞|翔|的|臀|部|穿|过|苹|果|树|影	2
高傲勇敢从容浴着血	高|傲|勇|敢|从|容|浴|着|血	0
才能在光辉之中享受欢欣，	才|能|在|光|辉|之|中|享|受|欢|欣|，	2
它们矗立着，仿佛是孤高的心灵，	它|们|矗|立|着|，|仿|佛|是|孤|高|的|心|灵|，	1
而爱情好似那曲调绵绵，	而|爱|情|好|似|那|曲|调|绵|绵|，	1
像在沙地上打洞。	像|在|沙|地|上|打|洞|。	1
仿佛用权杖或铁锤驱遣	仿|佛|用|权|杖|或|铁|锤|驱|遣	1
它的拜访是没有一定的，	它|的|拜|访|是|没|有|一|定|的|，	0
一页一页的连接和翻版；犹如薪火相传，	一|页|一|页|的|连|接|和|翻|版|；|犹|如|薪|火|相|传|，	1
温柔的气息，绾住了那阴影，不让它	温|柔|的|气|息|，|绾|住|了|那|阴|影|，|不|让|它	2
你的第一次手淫呼应着我的初经	你|的|第|一|次|手|淫|呼|应|着|我|的|初|经	0
宛如一头温顺的小羊。	宛|如|一|头|温|顺|的|小|羊|。	1
哦，我渴望珍藏一个秘密，犹如夏日的云朵裹着没有滴落的雨珠——一个包裹在静	哦|，|我|渴|望|珍|藏|一|个|秘|密|，|犹|如|夏|日|的|云|朵|裹|着|没|有|滴|落|的|雨|珠|—|—|一|个|包|裹|在|静	1
这悲伤并不充满着花街阴影的温柔，	这|悲|伤|并|不|充|满|着|花|街|阴|影|的|温|柔|，	2
仿佛那些死不宽恕的主教的面孔，刻错在石上的上帝的名字并不存在	仿|佛|那|些|死|不|宽|恕|的|主|教|的|面|孔|，|刻|错|在|石|上|的|上|帝|的|名|字|并|不|存|在	1
在通往郊区的路上，又肥又好看的	在|通|往|郊|区|的|路|上|，|又|肥|又|好|看|的	0
赤着的双足游玩。	赤|着|的|双|足|游|玩|。	2
这光焰在你疲惫的眼中挣扎；	这|光|焰|在|你|疲|惫|的|眼|中|挣|扎|；	2
那香石竹和玫瑰的卷发，	那|香|石|竹|和|玫|瑰|的|卷|发|，	2
一个迷恋手机游戏的人，他迷恋的就是贪吃蛇	一|个|迷|恋|手|机|游|戏|的|人|，|他|迷|恋|的|就|是|贪|吃|蛇	0
记忆像一艘船，	记|忆|像|一|艘|船|，	1
如此单纯而又神秘的槟榔树。	如|此|单|纯|而|又|神|秘|的|槟|榔|树|。	2
将王宫搞得惴惴不安	将|王|宫|搞|得|惴|惴|不|安	0
你不说它，它象刺一样慢跑在你的衰老里。	你|不|说|它|，|它|象|刺|一|样|慢|跑|在|你|的|衰|老|里|。	1
都充满了低微的哀怨．	都|充|满|了|低|微|的|哀|怨|．	2
在白色油灯周围	在|白|色|油|灯|周|围	0
那么，所谓的终极意义	那|么|，|所|谓|的|终|极|意|义	0
面对着如此广阔的大量财富	面|对|着|如|此|广|阔|的|大|量|财|富	2
仿佛是我遥远的中学时代	仿|佛|是|我|遥|远|的|中|学|时|代	1
黑得像铁。帝王消失时	黑|得|像|铁|。|帝|王|消|失|时|	1
曲线和缓的山峦，看见	曲|线|和|缓|的|山|峦|，|看|见	0
好象从神圣的桉树叶子上咬下的一口，愿这淫荡的神圣日	好|象|从|神|圣|的|桉|树|叶|子|上|咬|下|的|一|口|，|愿|这|淫|荡|的|神|圣|日	1
如果你好似悦乐的皇后，	如|果|你|好|似|悦|乐|的|皇|后|，	1
鸟呵　疲倦的鸟　大水上被风暴洗刷的眼睛	鸟|呵|　|疲|倦|的|鸟|　|大|水|上|被|风|暴|洗|刷|的|眼|睛	0
仿佛疯子于云端	仿|佛|疯|子|于|云|端	1
宛如我的双眼	宛|如|我|的|双|眼	1
仿佛来自于高大的树木，	仿|佛|来|自|于|高|大|的|树|木|，	1
“在我们旁边，离我们很近的地方，好像打扫干净	“|在|我|们|旁|边|，|离|我|们|很|近|的|地|方|，|好|像|打|扫|干|净	1
不会比梁赞的沃野更可爱。	不|会|比|梁|赞|的|沃|野|更|可|爱|。	2
月亮像金色的青蛙	月|亮|像|金|色|的|青|蛙	1
在肉体内就仿佛卡在一张	在|肉|体|内|就|仿|佛|卡|在|一|张	1
说罢，他仿佛已感到满意，便沉默不语。	说|罢|，|他|仿|佛|已|感|到|满|意|，|便|沉|默|不|语|。	1
脸色从害怕，变成暗淡。	脸|色|从|害|怕|，|变|成|暗|淡|。	2
不要温和地走进那个良夜，	不|要|温|和|地|走|进|那|个|良|夜|，	2
犹如利剑的魔法的尖刺。	犹|如|利|剑|的|魔|法|的|尖|刺|。	1
我的那头牯牛仿佛听见了鞭子的舞动声	我|的|那|头|牯|牛|仿|佛|听|见|了|鞭|子|的|舞|动|声	1
春天就像出生的婴儿，娇小可爱;春天就像活泼的儿童，憧憬渴望;春天就像健壮的青年，充满朝气;春天就像健康的老人，另人回味。	春|天|就|像|出|生|的|婴|儿|，|娇|小|可|爱|;|春|天|就|像|活|泼|的|儿|童|，|憧|憬|渴|望|;|春|天|就|像|健|壮|的|青|年|，|充|满|朝|气|;|春|天|就|像|健|康|的|老|人|，|另|人|回|味|。	2
我们去寻找一盏灯	我|们|去|寻|找|一|盏|灯	0
它害怕巨兽而乱伤小虫，令人可怜。	它|害|怕|巨|兽|而|乱|伤|小|虫|，|令|人|可|怜|。	2
仿佛对真理的触摸，遥不可及，又近在咫尺。	仿|佛|对|真|理|的|触|摸|，|遥|不|可|及|，|又|近|在|咫|尺|。	1
以及星星苍白的脸上，	以|及|星|星|苍|白|的|脸|上|，	2
当凄厉的风去追杀蝴蝶时	当|凄|厉|的|风|去|追|杀|蝴|蝶|时	2
她看见自己就是镜子	她|看|见|自|己|就|是|镜|子	0
仿佛是来此对质，	仿|佛|是|来|此|对|质|，	1
从柔软的外皮中钻出来	从|柔|软|的|外|皮|中|钻|出|来	0
他们留下的精子，是被水泥砌死的词。	他|们|留|下|的|精|子|，|是|被|水|泥|砌|死|的|词|。	0
喊着，――在这鸟儿勇敢的叫喊声里，乌云听到了欢乐。	喊|着|，|―|―|在|这|鸟|儿|勇|敢|的|叫|喊|声|里|，|乌|云|听|到|了|欢|乐|。	2
像你－－正在路程上	像|你|－|－|正|在|路|程|上	0
所有这些闪闪发光的海鸟烦躁地飞旋，	所|有|这|些|闪|闪|发|光|的|海|鸟|烦|躁|地|飞|旋|，	2
捧出水晶球般的食物，吹开热气	捧|出|水|晶|球|般|的|食|物|，|吹|开|热|气	0
肉体温起互相缠绕的渴望，	肉|体|温|起|互|相|缠|绕|的|渴|望|，	2
目光正经忙碌得	目|光|正|经|忙|碌|得	1
把混乱、疯狂的黑夜大军带向西方。	把|混|乱|、|疯|狂|的|黑|夜|大|军|带|向|西|方|。	2
屋檐象沉重的眼皮低垂。	屋|檐|象|沉|重|的|眼|皮|低|垂|。	2
好像宇宙在那儿寂寞地运行，	好|像|宇|宙|在|那|儿|寂|寞|地|运|行|，	1
其中的第二颗扣子，喉咙下面的	其|中|的|第|二|颗|扣|子|，|喉|咙|下|面|的	0
水天一时照成辉煌	水|天|一|时|照|成|辉|煌	0
雨的哗哗声像一柄巨大的扫帚将人们冲刷进各自温暖的房间。	雨|的|哗|哗|声|像|一|柄|巨|大|的|扫|帚|将|人|们|冲|刷|进|各|自|温|暖|的|房|间|。	1
睡得像一首歌谣，	睡|得|像|一|首|歌|谣|，	1
阻到了南方。而今天	阻|到|了|南|方|。|而|今|天	0
是远方的传说，一如光中的马匹	是|远|方|的|传|说|，|一|如|光|中|的|马|匹	1
就象紧紧地咬着伟大	就|象|紧|紧|地|咬|着|伟|大	1
好像是从河里流下来的冬日的断片，	好|像|是|从|河|里|流|下|来|的|冬|日|的|断|片|，	1
我头上天空明亮，树叶飒飒作响，鸟儿在歌唱……。	我|头|上|天|空|明|亮|，|树|叶|飒|飒|作|响|，|鸟|儿|在|歌|唱|…|…|。	2
北风携着风暴悄悄逃遁。	北|风|携|着|风|暴|悄|悄|逃|遁|。	2
这时清风从南边吹起她的头发	这|时|清|风|从|南|边|吹|起|她|的|头|发	0
知晓真理的人们深情的歌唱	知|晓|真|理|的|人|们|深|情|的|歌|唱	1
犹如一朵花在天空下面，	犹|如|一|朵|花|在|天|空|下|面|，	1
与形状或任其如水一般枉自东流。	与|形|状|或|任|其|如|水|一|般|枉|自|东|流|。	1
北方星光照耀南国星座	北|方|星|光|照|耀|南|国|星|座	0
那些金色的海岛，我们企盼已久，	那|些|金|色|的|海|岛|，|我|们|企|盼|已|久|，	1
像一场风暴刚刚结束	像|一|场|风|暴|刚|刚|结|束	1
他冲着大伙高声叫喊	他|冲|着|大|伙|高|声|叫|喊	0
多年过去仍然不愿意留下让人觉察的痕迹，像四季轮回的天气	多|年|过|去|仍|然|不|愿|意|留|下|让|人|觉|察|的|痕|迹|，|像|四|季|轮|回|的|天|气	1
犹如被遗弃的恋人，色泽暗黄	犹|如|被|遗|弃|的|恋|人|，|色|泽|暗|黄	1
慢缺肢蜥沿着门庭的楼梯流动，宁穆威武，像一条美洲蛇��	慢|缺|肢|蜥|沿|着|门|庭|的|楼|梯|流|动|，|宁|穆|威|武|，|像|一|条|美|洲|蛇|�|�	1
花儿从雪床中醒来，	花|儿|从|雪|床|中|醒|来|，	2
唱，一边冲向空中去迎接那雷声。	唱|，|一|边|冲|向|空|中|去|迎|接|那|雷|声|。	2
她一直保持着良好的饮食和睡眠	她|一|直|保|持|着|良|好|的|饮|食|和|睡|眠	0
仿佛这种思想有无尽的储藏。	仿|佛|这|种|思|想|有|无|尽|的|储|藏|。	1
可无聊象条蛇缠绕着枝藤	可|无|聊|象|条|蛇|缠|绕|着|枝|藤	1
还有许多可爱的花儿	还|有|许|多|可|爱|的|花|儿	2
仿佛你很早以前就知道地板会发出这样的响动……	仿|佛|你|很|早|以|前|就|知|道|地|板|会|发|出|这|样|的|响|动|…|…	1
从来没有留意过脚下即将移动的痕迹	从|来|没|有|留|意|过|脚|下|即|将|移|动|的|痕|迹	0
柔和如双簧管，青翠如绿草场，	柔|和|如|双|簧|管|，|青|翠|如|绿|草|场|，	1
妈妈象天空一样没有记性	妈|妈|象|天|空|一|样|没|有|记|性	1
看到这是一个温柔的十月的夜，	看|到|这|是|一|个|温|柔|的|十|月|的|夜|，	2
来的。	来|的|。	0
河谷的流水仿佛溢自	河|谷|的|流|水|仿|佛|溢|自	1
用鲜血给石头解渴	用|鲜|血|给|石|头|解|渴	2
一个阳台被安放在我的对面	一|个|阳|台|被|安|放|在|我|的|对|面	0
在那里，我能毫无烦恼地梦见	在|那|里|，|我|能|毫|无|烦|恼|地|梦|见	2
仿佛回忆，它精疲力尽	仿|佛|回|忆|，|它|精|疲|力|尽	1
就像一个饕餮的饭桶，我吃下一天的垃圾、灰尘、橡	就|像|一|个|饕|餮|的|饭|桶|，|我|吃|下|一|天|的|垃|圾|、|灰|尘|、|橡	1
再也回不到九五年的夏至了－－那充满 希望的日子	再|也|回|不|到|九|五|年|的|夏|至|了|－|－|那|充|满| |希|望|的|日|子	0
穿越界限并不迟疑	穿|越|界|限|并|不|迟|疑	0
她的脸像一只红白的桃子。	她|的|脸|像|一|只|红|白|的|桃|子|。	1
犹如久久地沉睡在惆怅的	犹|如|久|久|地|沉|睡|在|惆|怅|的	1
仿佛我用旧了的右手	仿|佛|我|用|旧|了|的|右|手	1
月  终于饱满	月| | |终|于|饱|满	0
把一切都忘记吧，就象猛烈的风暴	把|一|切|都|忘|记|吧|，|就|象|猛|烈|的|风|暴	1
平静的大师和哮喘发作的天才之间	平|静|的|大|师|和|哮|喘|发|作|的|天|才|之|间	1
星期二――大批大批的人离去了。在一片到处是黑卵石和海草堆，岩石上散满牲畜的巨大脊椎骨的荒凉海滩上，1与9之间展开了战斗	星|期|二|―|―|大|批|大|批|的|人|离|去|了|。|在|一|片|到|处|是|黑|卵|石|和|海|草|堆|，|岩|石|上|散|满|牲|畜|的|巨|大|脊|椎|骨|的|荒|凉|海|滩|上|，|1|与|9|之|间|展|开|了|战|斗	2
拼接口	拼|接|口	0
树在色彩中绿意纷呈	树|在|色|彩|中|绿|意|纷|呈	0
象是受了诅咒，在烈日炙烤下，	象|是|受|了|诅|咒|，|在|烈|日|炙|烤|下|，	1
的体垢！	的|体|垢|！	0
举止的温和简直就像是姑娘；	举|止|的|温|和|简|直|就|像|是|姑|娘|；	1
它遥望像是美丽的沃土，一片	它|遥|望|像|是|美|丽|的|沃|土|，|一|片	1
让自己变成坚硬透明的水晶。	让|自|己|变|成|坚|硬|透|明|的|水|晶|。	2
每当我提起水桶——他好像就站在井边，	每|当|我|提|起|水|桶|—|—|他|好|像|就|站|在|井|边|，	1
仿佛新生海洋的浪潮四面八方伸延	仿|佛|新|生|海|洋|的|浪|潮|四|面|八|方|伸|延	1
塔上纷纷努力的勇士纷纷掉入大海，	塔|上|纷|纷|努|力|的|勇|士|纷|纷|掉|入|大|海|，	0
一切尚未发生，正在发生；我注意到了，就象这雨	一|切|尚|未|发|生|，|正|在|发|生|；|我|注|意|到|了|，|就|象|这|雨	1
正如视力看到过分耀眼的东西而显得迷迷糊糊。	正|如|视|力|看|到|过|分|耀|眼|的|东|西|而|显|得|迷|迷|糊|糊|。	2
月光和神秘在此挥洒。	月|光|和|神|秘|在|此|挥|洒|。	2
在昏暗的房间，好象看到一个	在|昏|暗|的|房|间|，|好|象|看|到|一|个	0
在我舌下歌唱，它漂流的芬芳	在|我|舌|下|歌|唱|，|它|漂|流|的|芬|芳	2
象空气一样的这种东西，谁拽住了	象|空|气|一|样|的|这|种|东|西|，|谁|拽|住|了	1
这些如同珍藏在象牙的牙齿，	这|些|如|同|珍|藏|在|象|牙|的|牙|齿|，	1
哦，幸福的鸟儿，你在肩头微笑；	哦|，|幸|福|的|鸟|儿|，|你|在|肩|头|微|笑|；	2
“就是左边的这个。”	“|就|是|左|边|的|这|个|。|”	0
草地花似锦，林间鸟儿闹，	草|地|花|似|锦|，|林|间|鸟|儿|闹|，	2
森林宛如困在牢笼里的雄狮，绝望地抖动着颈鬣。	森|林|宛|如|困|在|牢|笼|里|的|雄|狮|，|绝|望|地|抖|动|着|颈|鬣|。	1
圣马丁广场我水中的居留地	圣|马|丁|广|场|我|水|中|的|居|留|地	0
差点在雨夜中迷失方向。	差|点|在|雨|夜|中|迷|失|方|向|。	0
我在寻找我住的城市	我|在|寻|找|我|住|的|城|市	0
夏士莲、圣罗兰还有小小一瓶雅诗兰黛	夏|士|莲|、|圣|罗|兰|还|有|小|小|一|瓶|雅|诗|兰|黛	0
1975年9月于团泊洼干校初稿的初稿，还需要做多次多次的修改，属于《参考消息》一类，万勿外传。	1|9|7|5|年|9|月|于|团|泊|洼|干|校|初|稿|的|初|稿|，|还|需|要|做|多|次|多|次|的|修|改|，|属|于|《|参|考|消|息|》|一|类|，|万|勿|外|传|。	0
像好莱坞鲍嘉老头活过来当了歹徒	像|好|莱|坞|鲍|嘉|老|头|活|过|来|当|了|歹|徒	1
忘不了的温暖。	忘|不|了|的|温|暖|。	0
速度，飞向虚无缥缈的天空，	速|度|，|飞|向|虚|无|缥|缈|的|天|空|，	0
离我而去，但仿佛是由于他的触摸	离|我|而|去|，|但|仿|佛|是|由|于|他|的|触|摸	1
断掉了联系，经受了一些苦难，	断|掉|了|联|系|，|经|受|了|一|些|苦|难|，	0
她不会动不动就生气、跺脚、打人	她|不|会|动|不|动|就|生|气|、|跺|脚|、|打|人	0
像一个转基因细胞，被盛大的春风	像|一|个|转|基|因|细|胞|，|被|盛|大|的|春|风	1
同时又仿佛有什么形而上在上升	同|时|又|仿|佛|有|什|么|形|而|上|在|上|升	1
我那时尚能看见一个世界	我|那|时|尚|能|看|见|一|个|世|界	0
你双唇上的亲吻象一根缓缓的芒刺，	你|双|唇|上|的|亲|吻|象|一|根|缓|缓|的|芒|刺|，	1
界碑躲在老墓后已奄奄一息	界|碑|躲|在|老|墓|后|已|奄|奄|一|息	2
像是永不绝望的绝望	像|是|永|不|绝|望|的|绝|望	1
就是一颗梨	就|是|一|颗|梨	1
又像是琥珀朦胧地泛光。	又|像|是|琥|珀|朦|胧|地|泛|光|。	1
海妖们的歌唱，在篱笆那边	海|妖|们|的|歌|唱|，|在|篱|笆|那|边	2
不知是你将冬季涂黑	不|知|是|你|将|冬|季|涂|黑	0
吸吮痛苦犹如母狼！	吸|吮|痛|苦|犹|如|母|狼|！	1
仿佛是马蹄得得的声音。	仿|佛|是|马|蹄|得|得|的|声|音|。	1
十一月来了，好像什么也不是。	十|一|月|来|了|，|好|像|什|么|也|不|是|。	1
遥远的天堂也被吓得够呛。	遥|远|的|天|堂|也|被|吓|得|够|呛|。	0
元音们休假的时间虽然很长，	元|音|们|休|假|的|时|间|虽|然|很|长|，	0
不再打扰你	不|再|打|扰|你	0
那暴戾的大海把千万条头巾堆放在你的脚下，犹如一条着魔的巨蛇暂且宁静。	那|暴|戾|的|大|海|把|千|万|条|头|巾|堆|放|在|你|的|脚|下|，|犹|如|一|条|着|魔|的|巨|蛇|暂|且|宁|静|。	1
感觉你耳后草原如海水	感|觉|你|耳|后|草|原|如|海|水	1
它也许不合你秋天的季节，但到明春准会生根发芽。……	它|也|许|不|合|你|秋|天|的|季|节|，|但|到|明|春|准|会|生|根|发|芽|。|…|…	0
－－瞧我说的，仿佛花朵	－|－|瞧|我|说|的|，|仿|佛|花|朵	1
孩儿，谁不害怕！但等那时辰来到，	孩|儿|，|谁|不|害|怕|！|但|等|那|时|辰|来|到|，	2
它红润的裸足	它|红|润|的|裸|足	0
使鱼看起来仿佛是在水之外一样	使|鱼|看|起|来|仿|佛|是|在|水|之|外|一|样	1
倦于闪耀的油灯使旷野暗淡	倦|于|闪|耀|的|油|灯|使|旷|野|暗|淡	0
好比葬身坟墓。	好|比|葬|身|坟|墓|。	1
那些直指心灵的是约伯、祈祷和假象	那|些|直|指|心|灵|的|是|约|伯|、|祈|祷|和|假|象	0
蔷薇说：“我要刺你，	蔷|薇|说|：|“|我|要|刺|你|，	2
犹如谷粒，写着“赠给伊凡诺娃”，	犹|如|谷|粒|，|写|着|“|赠|给|伊|凡|诺|娃|”|，	1
你神体的下端，像一炬烛光	你|神|体|的|下|端|，|像|一|炬|烛|光	1
仿佛眼睛开了花	仿|佛|眼|睛|开|了|花	1
王小淇眼泪潸潸，她不读小说	王|小|淇|眼|泪|潸|潸|，|她|不|读|小|说	0
那金色的嗓音充满无限的忧郁。	那|金|色|的|嗓|音|充|满|无|限|的|忧|郁|。	2
仿佛弄潮儿在浪里荡魄销魂，	仿|佛|弄|潮|儿|在|浪|里|荡|魄|销|魂|，	1
他本人仿佛是一个被保护者……可是在内心：谁会	他|本|人|仿|佛|是|一|个|被|保|护|者|…|…|可|是|在|内|心|：|谁|会	1
放大了鸣叫的尖锐度∶而她喑哑的语调	放|大|了|鸣|叫|的|尖|锐|度|∶|而|她|喑|哑|的|语|调	2
像嫉妒的女仆们喋喋不休，	像|嫉|妒|的|女|仆|们|喋|喋|不|休|，	1
一直在证明	一|直|在|证|明	0
瞧我们多象一对古装偶人，	瞧|我|们|多|象|一|对|古|装|偶|人|，	1
或者把足球	或|者|把|足|球	0
论证如下：男性生殖器、笔和我们的枪。	论|证|如|下|：|男|性|生|殖|器|、|笔|和|我|们|的|枪|。	0
宛如长矛杆头镶饰的珍珠串串	宛|如|长|矛|杆|头|镶|饰|的|珍|珠|串|串	1
像多肢的绿色昆虫缓缓进站	像|多|肢|的|绿|色|昆|虫|缓|缓|进|站	1
前阶的青草仿佛在摇摆，	前|阶|的|青|草|仿|佛|在|摇|摆|，	1
钟声敲打着临危不惧的乡村	钟|声|敲|打|着|临|危|不|惧|的|乡|村	2
只有你的影子仿佛来自远古，在安息的海的镜面上涟漪般展开，投放	只|有|你|的|影|子|仿|佛|来|自|远|古|，|在|安|息|的|海|的|镜|面|上|涟|漪|般|展|开|，|投|放	1
让他们的情调	让|他|们|的|情|调	0
可是我突然觉得，他像是	可|是|我|突|然|觉|得|，|他|像|是	1
你们在笑,好像不以为然。	你|们|在|笑|,|好|像|不|以|为|然|。	1
亲爱的，让我去死吧，让我再从头开始	亲|爱|的|，|让|我|去|死|吧|，|让|我|再|从|头|开|始	1
我的出生正是你死亡	我|的|出|生|正|是|你|死|亡	0
他躲在里面整理衣装、笑脸	他|躲|在|里|面|整|理|衣|装|、|笑|脸	0
冷酷和残忍的代名词	冷|酷|和|残|忍|的|代|名|词	0
仿佛我成了一条疯狗，	仿|佛|我|成|了|一|条|疯|狗|，	1
明亮的绿叶在大门旁燃烧，	明|亮|的|绿|叶|在|大|门|旁|燃|烧|，	2
一个婊子要生多少娃	一|个|婊|子|要|生|多|少|娃	0
奴役人如同役使畜牲	奴|役|人|如|同|役|使|畜|牲	1
仿佛用青铜器皿，盛上清酒，就	仿|佛|用|青|铜|器|皿|，|盛|上|清|酒|，|就	1
就象难忍的晚上。	就|象|难|忍|的|晚|上|。	1
最后看一眼房屋后海上的黄昏	最|后|看|一|眼|房|屋|后|海|上|的|黄|昏	0
是月亮重如一粒子弹	是|月|亮|重|如|一|粒|子|弹	0
皎洁的明月高挂在淡蓝色的天空中,月光像流水一样泻下来,大地一片银白色.	皎|洁|的|明|月|高|挂|在|淡|蓝|色|的|天|空|中|,|月|光|像|流|水|一|样|泻|下|来|,|大|地|一|片|银|白|色|.	1
里仿佛感觉到暴风云的楚痛，绿树渴望挣脱那根深蒂固的脚镣。	里|仿|佛|感|觉|到|暴|风|云|的|楚|痛|，|绿|树|渴|望|挣|脱|那|根|深|蒂|固|的|脚|镣|。	1
沉睡的大地之夜已然降临，	沉|睡|的|大|地|之|夜|已|然|降|临|，	2
听那钟声辛酸中带着温存，	听|那|钟|声|辛|酸|中|带|着|温|存|，	2
就像行走的天鹅那样笨拙。	就|像|行|走|的|天|鹅|那|样|笨|拙|。	1
象一些肉体丰硕的牡丹离开纸张	象|一|些|肉|体|丰|硕|的|牡|丹|离|开|纸|张	1
大海不会徒劳地掀起波澜。	大|海|不|会|徒|劳|地|掀|起|波|澜|。	2
沉睡的群山的寂静，	沉|睡|的|群|山|的|寂|静|，	2
像是从前某个夜晚遗落的微雨	像|是|从|前|某|个|夜|晚|遗|落|的|微|雨	0
都苍白得像是骷髅；	都|苍|白|得|像|是|骷|髅|；	1
目光好像明灯两盏，	目|光|好|像|明|灯|两|盏|，	1
让风儿找不见	让|风|儿|找|不|见	2
下来，好像预先约定好似的，又像受了电击一般。可尊敬	下|来|，|好|像|预|先|约|定|好|似|的|，|又|像|受|了|电|击|一|般|。|可|尊|敬	1
广阔之爱的无私给予者	广|阔|之|爱|的|无|私|给|予|者	2
但是我永远不讨厌它，	但|是|我|永|远|不|讨|厌|它|，	0
我只能左手提一把青菜右手挽一条鱼	我|只|能|左|手|提|一|把|青|菜|右|手|挽|一|条|鱼	0
那是从前的高楼大厦啊	那|是|从|前|的|高|楼|大|厦|啊	2
在你睡着的时候	在|你|睡|着|的|时|候	0
两朵花，就像两个人	两|朵|花|，|就|像|两|个|人	1
当真理象胃痛一样难以忍受	当|真|理|象|胃|痛|一|样|难|以|忍|受	2
就好像今夜使人崩溃的宁静	就|好|像|今|夜|使|人|崩|溃|的|宁|静	1
美丽如同花园的女诗人们	美|丽|如|同|花|园|的|女|诗|人|们	1
夏天穿白裙子的王小淇	夏|天|穿|白|裙|子|的|王|小|淇	0
就象离开了月光	就|象|离|开|了|月|光	1
他躺在四尺长的木箱里就像躺在儿童床里，	他|躺|在|四|尺|长|的|木|箱|里|就|像|躺|在|儿|童|床|里|，	1
我好像答应过你	我|好|像|答|应|过|你	1
使我热情地生活，为理想而痛苦，	使|我|热|情|地|生|活|，|为|理|想|而|痛|苦|，	0
时间在蒸发，你的生命也象一炷香一样	时|间|在|蒸|发|，|你|的|生|命|也|象|一|炷|香|一|样	1
像青蛙般呱呱唱着歌儿。	像|青|蛙|般|呱|呱|唱|着|歌|儿|。	1
好像暴风雪	好|像|暴|风|雪	1
时间中的风声、中箭而亡的主人、马	时|间|中|的|风|声|、|中|箭|而|亡|的|主|人|、|马	0
花娉四裂花冠象漏斗一样四裂	花|娉|四|裂|花|冠|象|漏|斗|一|样|四|裂	1
要旋转，像一颗蚕茧那样	要|旋|转|，|像|一|颗|蚕|茧|那|样	1
写下那些	写|下|那|些	0
像春草般怒茁于大地，	像|春|草|般|怒|茁|于|大|地|，	1
一个在前一个在后	一|个|在|前|一|个|在|后	0
阳春又来到我们身边，	阳|春|又|来|到|我|们|身|边|，	2
因为只有那里是太阳，是春，	因|为|只|有|那|里|是|太|阳|，|是|春|，	0
像是在困倦的梦里，呼吸微微。	像|是|在|困|倦|的|梦|里|，|呼|吸|微|微|。	1
看，犹如一枝天鹅的羽毛，	看|，|犹|如|一|枝|天|鹅|的|羽|毛|，	1
他的脸色，仿佛被一阵阵小风吹得云散天开，渐渐明朗起来。	他|的|脸|色|，|仿|佛|被|一|阵|阵|小|风|吹|得|云|散|天|开|，|渐|渐|明|朗|起|来|。	1
——我说的是：那密密层层宛如森林的一群鬼魂。	—|—|我|说|的|是|：|那|密|密|层|层|宛|如|森|林|的|一|群|鬼|魂|。	1
如白色幽灵淌过这黑色长河；	如|白|色|幽|灵|淌|过|这|黑|色|长|河|；	1
仰望晴空，五月的晴空，麦垛的晴空	仰|望|晴|空|，|五|月|的|晴|空|，|麦|垛|的|晴|空	0
在雨水和纸片的飞舞中	在|雨|水|和|纸|片|的|飞|舞|中	0
因为凡人用词犹如	因|为|凡|人|用|词|犹|如	1
我瞧见有人在山那边眨眼	我|瞧|见|有|人|在|山|那|边|眨|眼	0
仿佛晨曦同样为往世而升起	仿|佛|晨|曦|同|样|为|往|世|而|升|起	1
才能被人称作男子汉	才|能|被|人|称|作|男|子|汉	0
而且被无数的恶梦纠缠。	而|且|被|无|数|的|恶|梦|纠|缠|。	0
犹如山岭驮着山岭	犹|如|山|岭|驮|着|山|岭	1
像赤身上战场的人	像|赤|身|上|战|场|的|人	1
像母亲般，即使对逆子或坏人；	像|母|亲|般|，|即|使|对|逆|子|或|坏|人|；	1
像是说起　她预备多年的柚木棺材	像|是|说|起|　|她|预|备|多|年|的|柚|木|棺|材	1
仿佛一阵风吹来	仿|佛|一|阵|风|吹|来	1
仿佛到处金果丰盈。	仿|佛|到|处|金|果|丰|盈|。	1
我的火中空落了一场雨	我|的|火|中|空|落|了|一|场|雨	0
仿佛一切都不曾	仿|佛|一|切|都|不|曾	0
像一万朵玫瑰凄怆的金嗓子被夕阳点燃了。	像|一|万|朵|玫|瑰|凄|怆|的|金|嗓|子|被|夕|阳|点|燃|了|。	1
它与第六种感官的意义分离	它|与|第|六|种|感|官|的|意|义|分|离	0
你也该心满意足；请欣赏她那舞姿的优美，犹如欣赏一棵波光粼粼的迷人的水面上舞蹈	你|也|该|心|满|意|足|；|请|欣|赏|她|那|舞|姿|的|优|美|，|犹|如|欣|赏|一|棵|波|光|粼|粼|的|迷|人|的|水|面|上|舞|蹈	1
你看这天空　多像一个盖子	你|看|这|天|空|　|多|像|一|个|盖|子	1
犹如一朵花在天空下面，	犹|如|一|朵|花|在|天|空|下|面|，	1
像干涸的河床	像|干|涸|的|河|床	1
而马路尽头，正慢性哮喘般喷薄出城市	而|马|路|尽|头|，|正|慢|性|哮|喘|般|喷|薄|出|城|市	2
每个人是旅行的前兆，我们总之要出门	每|个|人|是|旅|行|的|前|兆|，|我|们|总|之|要|出|门	0
春天是个害羞的小姑娘，遮遮掩掩，躲躲藏藏;春天是出生的婴儿，娇小可爱。	春|天|是|个|害|羞|的|小|姑|娘|，|遮|遮|掩|掩|，|躲|躲|藏|藏|;|春|天|是|出|生|的|婴|儿|，|娇|小|可|爱|。	2
我叫他出来	我|叫|他|出|来	0
我也想踢一场足球了	我|也|想|踢|一|场|足|球|了	0
它两颊深陷，仿佛它只是喝空气，	它|两|颊|深|陷|，|仿|佛|它|只|是|喝|空|气|，	1
你用光热哺育我的观念和思想――	你|用|光|热|哺|育|我|的|观|念|和|思|想|―|―	0
他为镜中的标语而困惑	他|为|镜|中|的|标|语|而|困|惑	0
犹如居住在宏伟、安宁、惬意的天宇中的天使。	犹|如|居|住|在|宏|伟|、|安|宁|、|惬|意|的|天|宇|中|的|天|使|。	1
大门微笑着相互致意	大|门|微|笑|着|相|互|致|意	2
音乐倾倒，像痛得销魂的少女	音|乐|倾|倒|，|像|痛|得|销|魂|的|少|女	1
天外也还有乐园。	天|外|也|还|有|乐|园|。	0
你神体的下端，像一炬烛光	你|神|体|的|下|端|，|像|一|炬|烛|光	1
马:它走了,不肯说话。	马|:|它|走|了|,|不|肯|说|话|。	2
象打谷场上飞迸的谷糠。	象|打|谷|场|上|飞|迸|的|谷|糠|。	1
跃入冰水里幽黑的清晨	跃|入|冰|水|里|幽|黑|的|清|晨	0
从前神圣的祖国，神圣的家乡，	从|前|神|圣|的|祖|国|，|神|圣|的|家|乡|，	0
而爱情好似那曲调绵绵，	而|爱|情|好|似|那|曲|调|绵|绵|，	1
我不是弱者――我不会沾沾自喜，	我|不|是|弱|者|―|―|我|不|会|沾|沾|自|喜|，	0
有时候仿佛一枚金币	有|时|候|仿|佛|一|枚|金|币	1
矮树，广告，绿色的	矮|树|，|广|告|，|绿|色|的	0
好象在做一个永恒的苦役。	好|象|在|做|一|个|永|恒|的|苦|役|。	1
在台阶上你把手伸给我	在|台|阶|上|你|把|手|伸|给|我	0
钻石带着光辉来到人间	钻|石|带|着|光|辉|来|到|人|间	0
一天过去，犹如离枝一叶。	一|天|过|去|，|犹|如|离|枝|一|叶|。	1
我是怎样被召唤而来，却不能离去	我|是|怎|样|被|召|唤|而|来|，|却|不|能|离|去	0
蔚蓝的烟跃起，仿佛	蔚|蓝|的|烟|跃|起|，|仿|佛	1
到唐朝去死。天才与美玉	到|唐|朝|去|死|。|天|才|与|美|玉	0
仿佛那水流急湍，	仿|佛|那|水|流|急|湍|，	1
就象一群大的飞鸟，	就|象|一|群|大|的|飞|鸟|，	1
秋天像是出海归来的渔船，满载人们的欣喜。	秋|天|像|是|出|海|归|来|的|渔|船|，|满|载|人|们|的|欣|喜|。	1
而我好似五月的贵族，	而|我|好|似|五|月|的|贵|族|，	1
我的杯子破了仿佛爆发出一阵大笑	我|的|杯|子|破|了|仿|佛|爆|发|出|一|阵|大|笑	2
仿佛炭笔画出无效线条；	仿|佛|炭|笔|画|出|无|效|线|条|；	1
是那么细，那么软……现在只有蓬蒿；	是|那|么|细|，|那|么|软|…|…|现|在|只|有|蓬|蒿|；	0
赫:它招手叫您过去.好像想单独的与您谈话。	赫|:|它|招|手|叫|您|过|去|.|好|像|想|单|独|的|与|您|谈|话|。	1
夜的黑暗充满无限的恐怖，	夜|的|黑|暗|充|满|无|限|的|恐|怖|，	2
你可得到的’，我双手	你|可|得|到|的|’|，|我|双|手	0
犹如走兽在舔着自己的毛皮。	犹|如|走|兽|在|舔|着|自|己|的|毛|皮|。	1
看，犹如一枝天鹅的羽毛，	看|，|犹|如|一|枝|天|鹅|的|羽|毛|，	1
就唱起不懂的歌	就|唱|起|不|懂|的|歌	0
几乎像是太阳照射的金刚石那样晶莹。	几|乎|像|是|太|阳|照|射|的|金|刚|石|那|样|晶|莹|。	1
嚎啕痛哭，像下雨一样。	嚎|啕|痛|哭|，|像|下|雨|一|样|。	1
重新长出花的坟墓在叹息：	重|新|长|出|花|的|坟|墓|在|叹|息|：	2
我想把它说出来	我|想|把|它|说|出|来	0
方面的才能完美地移植到了诗的创作上。《呼唤声》一诗	方|面|的|才|能|完|美|地|移|植|到|了|诗|的|创|作|上|。|《|呼|唤|声|》|一|诗	2
我会说：这大海也越来越旧了	我|会|说|：|这|大|海|也|越|来|越|旧|了	0
赤身行走宛如我的思想，	赤|身|行|走|宛|如|我|的|思|想|，	1
它象期待着我的花朵，	它|象|期|待|着|我|的|花|朵|，	1
春风像个慈祥的母亲,拂着你的脸颊,使你感到舒畅,心旷神怡.	春|风|像|个|慈|祥|的|母|亲|,|拂|着|你|的|脸|颊|,|使|你|感|到|舒|畅|,|心|旷|神|怡|.	1
“用外省的口音招呼它们	“|用|外|省|的|口|音|招|呼|它|们	0
它曾在我的脑海中彗星一样一闪而过	它|曾|在|我|的|脑|海|中|彗|星|一|样|一|闪|而|过	1
羽毛纷乱如雪。也照出她的一切结束在一个瞬息	羽|毛|纷|乱|如|雪|。|也|照|出|她|的|一|切|结|束|在|一|个|瞬|息	1
它瘦骨嶙峋，像是满抱种种贪婪欲望，	它|瘦|骨|嶙|峋|，|像|是|满|抱|种|种|贪|婪|欲|望|，	1
就变了	就|变|了	0
是影子中有玉米。历史朽烂了	是|影|子|中|有|玉|米|。|历|史|朽|烂|了	0
才下定决心――然而还只是仿佛。	才|下|定|决|心|―|―|然|而|还|只|是|仿|佛|。	1
好像水车在脑里旋转。	好|像|水|车|在|脑|里|旋|转|。	1
充满着你，仿佛绿色的夜雾	充|满|着|你|，|仿|佛|绿|色|的|夜|雾	1
是难听的方言，腐烂的食物	是|难|听|的|方|言|，|腐|烂|的|食|物	0
坏情绪不会构成骚扰	坏|情|绪|不|会|构|成|骚|扰	2
野火，吻着全部草地	野|火|，|吻|着|全|部|草|地	0
时间也仿佛不存在	时|间|也|仿|佛|不|存|在	1
用千万只手挣扎在虚幻的水草里	用|千|万|只|手|挣|扎|在|虚|幻|的|水|草|里	0
在那里闪耀，仿佛高尚开始显形	在|那|里|闪|耀|，|仿|佛|高|尚|开|始|显|形	1
而种子跳跃着敞开明亮的天光	而|种|子|跳|跃|着|敞|开|明|亮|的|天|光	2
我在梦中竟也梦见我的诗歌	我|在|梦|中|竟|也|梦|见|我|的|诗|歌	0
而像女学生穿著毛线衣一样多彩的	而|像|女|学|生|穿|著|毛|线|衣|一|样|多|彩|的	2
车子开动  大地随落日	车|子|开|动| | |大|地|随|落|日	0
我们仿佛不止一次地觉得，	我|们|仿|佛|不|止|一|次|地|觉|得|，	1
弯弯的月亮像一条船，自由地在夜空飘零	弯|弯|的|月|亮|像|一|条|船|，|自|由|地|在|夜|空|飘|零	1
在没有人的时候	在|没|有|人|的|时|候	0
“去吧，去吧，就象妈妈平时给你买玩具车那样	“|去|吧|，|去|吧|，|就|象|妈|妈|平|时|给|你|买|玩|具|车|那|样	1
都会到田野上去	都|会|到|田|野|上|去	0
在对人世充满厌恶和仇视的荒地上	在|对|人|世|充|满|厌|恶|和|仇|视|的|荒|地|上	2
轻松成熟起来，既无名目，也无形态，如大海一样，只容	轻|松|成|熟|起|来|，|既|无|名|目|，|也|无|形|态|，|如|大|海|一|样|，|只|容	2
白垩的光，白垩的表面像是自生自灭的晶体	白|垩|的|光|，|白|垩|的|表|面|像|是|自|生|自|灭|的|晶|体	1
宛如水底的珍珠。	宛|如|水|底|的|珍|珠|。	1
仿佛天堂落下的一朵雪花。它想下来	仿|佛|天|堂|落|下|的|一|朵|雪|花|。|它|想|下|来	1
所以你的往事越来厚重难能可贵	所|以|你|的|往|事|越|来|厚|重|难|能|可|贵	0
浓雾阻塞着我就象奶油	浓|雾|阻|塞|着|我|就|象|奶|油	1
可是刀子　刀子突然不见了	可|是|刀|子|　|刀|子|突|然|不|见|了	0
一种节奏则超越亮光	一|种|节|奏|则|超|越|亮|光	0
是这白雪一片的雾气，在天地间	是|这|白|雪|一|片|的|雾|气|，|在|天|地|间	0
暴风雪在久久地唱歌和鸣响。	暴|风|雪|在|久|久|地|唱|歌|和|鸣|响|。	2
好像你已经死了，	好|像|你|已|经|死|了|，	1
犹如植物的液汁。	犹|如|植|物|的|液|汁|。	1
被隐秘的护拦网捕散，下班的民工匆匆收拾着	被|隐|秘|的|护|拦|网|捕|散|，|下|班|的|民|工|匆|匆|收|拾|着	0
象女王一样	象|女|王|一|样	1
鬼的精灵。	鬼|的|精|灵|。	0
下雨的日子穿着鲜艳的雨衣	下|雨|的|日|子|穿|着|鲜|艳|的|雨|衣	2
在轻风中微颤着，如一叶白帆。	在|轻|风|中|微|颤|着|，|如|一|叶|白|帆|。	1
下在山里	下|在|山|里	0
恰似小鸟儿复盖在绒毛里。	恰|似|小|鸟|儿|复|盖|在|绒|毛|里|。	1
使世界繁殖，仿佛生殖的行为，	使|世|界|繁|殖|，|仿|佛|生|殖|的|行|为|，	1
以本我为核心的脑子总是无法清醒	以|本|我|为|核|心|的|脑|子|总|是|无|法|清|醒	0
云倚高峰上，犹如我倚君。	云|倚|高|峰|上|，|犹|如|我|倚|君|。	1
清凉宜人犹如地下的泉水，纯净可饮。	清|凉|宜|人|犹|如|地|下|的|泉|水|，|纯|净|可|饮|。	1
记忆之父伸出双手，挽起圆形厅堂里的女孩	记|忆|之|父|伸|出|双|手|，|挽|起|圆|形|厅|堂|里|的|女|孩	2
是失业的锁匠们最先把你望到	是|失|业|的|锁|匠|们|最|先|把|你|望|到	0
我曾经在一个提刀的青年家中喝醉	我|曾|经|在|一|个|提|刀|的|青|年|家|中|喝|醉	0
在你头发的庇护下，在你那象比邻的太阳一样的眼睛的照	在|你|头|发|的|庇|护|下|，|在|你|那|象|比|邻|的|太|阳|一|样|的|眼|睛|的|照	1
广大浩漫好像黑夜连着光明——	广|大|浩|漫|好|像|黑|夜|连|着|光|明|—|—	1
顽固地爬向天花板	顽|固|地|爬|向|天|花|板	0
仿佛一切生命都已安息。	仿|佛|一|切|生|命|都|已|安|息|。	1
它好像是盘卷的蛇突然伸直，	它|好|像|是|盘|卷|的|蛇|突|然|伸|直|，	1
风的手比人的脚步	风|的|手|比|人|的|脚|步	2
仿佛对真理的触摸，遥不可及，又近在咫尺。	仿|佛|对|真|理|的|触|摸|，|遥|不|可|及|，|又|近|在|咫|尺|。	1
梦中的学校	梦|中|的|学|校	1
风儿温柔的吹，海水在风的摇篮里睡了。	风|儿|温|柔|的|吹|，|海|水|在|风|的|摇|篮|里|睡|了|。	2
无所凭借，像瓶中的胎儿，	无|所|凭|借|，|像|瓶|中|的|胎|儿|，	1
黑水晶面对铁锤必须绽开微笑	黑|水|晶|面|对|铁|锤|必|须|绽|开|微|笑	2
漫不经心地蠕动着	漫|不|经|心|地|蠕|动|着	0
像尘埃一样降落，消失于人群之中。	像|尘|埃|一|样|降|落|，|消|失|于|人|群|之|中|。	1
车链掉了车蹬就一定踏得飞快	车|链|掉|了|车|蹬|就|一|定|踏|得|飞|快	0
寒霜像幽灵般发灰，	寒|霜|像|幽|灵|般|发|灰|，	1
我一觉醒来，看见空荡荡的房间。	我|一|觉|醒|来|，|看|见|空|荡|荡|的|房|间|。	0
就像一棵树上	就|像|一|棵|树|上	1
和所有以梦为马的诗人一样	和|所|有|以|梦|为|马|的|诗|人|一|样	0
爱得热烈执着的往往是小巧的女郎。	爱|得|热|烈|执|着|的|往|往|是|小|巧|的|女|郎|。	2
阳光和云彩穿梭嬉戏	阳|光|和|云|彩|穿|梭|嬉|戏	2
我的幻梦，犹如诡秘的面包的酵母，	我|的|幻|梦|，|犹|如|诡|秘|的|面|包|的|酵|母|，	1
犹如任何其他种子离开属于它的地方。	犹|如|任|何|其|他|种|子|离|开|属|于|它|的|地|方|。	1
我的灵魂可以转世，但幸福犹如悬于弦上	我|的|灵|魂|可|以|转|世|，|但|幸|福|犹|如|悬|于|弦|上	1
我减少了，我身上所能	我|减|少|了|，|我|身|上|所|能	0
郊外的磨坊打着盹儿，	郊|外|的|磨|坊|打|着|盹|儿|，	2
春天，像一面徐徐展开的新美的画卷	春|天|，|像|一|面|徐|徐|展|开|的|新|美|的|画|卷	1
阳光，象千瓦的白炽灯	阳|光|，|象|千|瓦|的|白|炽|灯	1
至今仍是一片野蛮的森林	至|今|仍|是|一|片|野|蛮|的|森|林	0
而我，宁愿在山顶呆着，以便我，	而|我|，|宁|愿|在|山|顶|呆|着|，|以|便|我|，	0
如昔日菖蒲的花蕊	如|昔|日|菖|蒲|的|花|蕊	1
毛烘烘的大皮子。	毛|烘|烘|的|大|皮|子|。	0
仿佛耶稣的重返	仿|佛|耶|稣|的|重|返	1
坚定的影子就乱了，就害怕	坚|定|的|影|子|就|乱|了|，|就|害|怕	0
